cell	cluster
BM4_AAAAAACATACG	earlyEry
BM4_AAAAACTTCTAT	earlyEry
BM4_AAAAATCTGAGA	earlyEry
BM4_AAAACACGAATA	ProMono
BM4_AAAACGTCGCTN	NK
BM4_AAAAGACTGTAT	earlyEry
BM4_AAAAGAGTCCAN	CTL
BM4_AAAAGTTTCAGN	CTL
BM4_AAAATCATGGGN	Prog
BM4_AAAATCATTAAT	GMP
BM4_AAAATGTTATGG	NK
BM4_AAAATGTTTCGG	T
BM4_AAACAAACTTGC	Prog
BM4_AAACAAGCCGGN	earlyEry
BM4_AAACACACGCTG	Mono
BM4_AAACACCACGCG	cDC
BM4_AAACAGAATCAT	Mono
BM4_AAACCAATTAGN	Prog
BM4_AAACCGCGTGGC	cDC
BM4_AAACGAGGCAAT	earlyEry
BM4_AAACGGAAACTC	Mono
BM4_AAACGTCTACCN	Mono
BM4_AAACTCGCCTGA	T
BM4_AAACTTTCTTCA	T
BM4_AAAGAACCCCGT	Prog
BM4_AAAGAGCGCCGG	T
BM4_AAAGCAAATTTC	T
BM4_AAAGCATCGATN	T
BM4_AAAGCCTTCGAG	Prog
BM4_AAAGCGATCGGC	earlyEry
BM4_AAAGCTTGGCTG	CTL
BM4_AAAGGCCTGGTC	Prog
BM4_AAAGGTAGGTTC	B
BM4_AAAGTGGGTCCG	Mono
BM4_AAATACTCAGGN	ProMono
BM4_AAATAGCTTACG	lateEry
BM4_AAATATTCCCAA	T
BM4_AAATCGTGTGAG	NK
BM4_AAATGAGGCGAA	ProB
BM4_AAATGATAGTGN	T
BM4_AAATGGAATTCN	ProMono
BM4_AAATGGCTGCTT	Prog
BM4_AAATTCAAGTCG	CTL
BM4_AAATTGCACACC	Mono
BM4_AAATTTGAGGGN	Mono
BM4_AAATTTTGAGCN	cDC
BM4_AACAAAACGGGA	earlyEry
BM4_AACAAACCTCAN	earlyEry
BM4_AACAAACTTCCN	T
BM4_AACACCGTTGAG	Prog
BM4_AACACTCGAATN	pDC
BM4_AACAGCTGCCCA	Mono
BM4_AACAGGAGGCTG	ProMono
BM4_AACAGGAGTTGN	earlyEry
BM4_AACATACGTGAT	B
BM4_AACATATTCCGG	T
BM4_AACATCCAGTTA	earlyEry
BM4_AACCAAAAGGTT	T
BM4_AACCAAAGCTCG	Prog
BM4_AACCAACGAGAN	T
BM4_AACCAAGCAACN	earlyEry
BM4_AACCAGGAATCC	Prog
BM4_AACCAGGGACGG	ProMono
BM4_AACCATGTGAGT	ProMono
BM4_AACCCTACCTTN	pDC
BM4_AACCGCCGAACN	GMP
BM4_AACCTAAGGAGT	ProMono
BM4_AACCTGAGGATN	lateEry
BM4_AACCTTAACAAG	Prog
BM4_AACGAGTTTCAN	ProMono
BM4_AACGCGACGGCA	cDC
BM4_AACGCGTAACAT	T
BM4_AACGCTCGTTTN	Prog
BM4_AACGGCGTTGCG	Prog
BM4_AACGTGGCTGCA	ProMono
BM4_AACGTTCTACTG	ProMono
BM4_AACTAACAGGCT	cDC
BM4_AACTCGCATCAA	T
BM4_AACTCGCCATGC	ProMono
BM4_AACTCGTCCATA	cDC
BM4_AACTGTAAGGTC	T
BM4_AACTTCATGTTN	Plasma
BM4_AACTTCCCGGTN	T
BM4_AACTTTTAATAN	Mono
BM4_AAGAAAGAGTCN	lateEry
BM4_AAGAACCTTCAN	NK
BM4_AAGAAGGTGTTC	cDC
BM4_AAGACAGCTATT	cDC
BM4_AAGACTACCATG	ProB
BM4_AAGACTACGATA	CTL
BM4_AAGAGCGATTGT	B
BM4_AAGAGGTCGACN	GMP
BM4_AAGAGTAACTGG	ProB
BM4_AAGAGTGATCAG	CTL
BM4_AAGATCGCGACC	T
BM4_AAGATGCAATCA	ProMono
BM4_AAGATGGAATTC	B
BM4_AAGATTGTCGCC	T
BM4_AAGCAAGTTGGN	Mono
BM4_AAGCAATAACTC	T
BM4_AAGCCACTCGTT	cDC
BM4_AAGCCGATATCA	earlyEry
BM4_AAGCCTAATCTT	CTL
BM4_AAGCCTACTACN	T
BM4_AAGCGCATGTTT	T
BM4_AAGCGCCGGGCN	Plasma
BM4_AAGCTATCTGAG	earlyEry
BM4_AAGCTTACGGAC	CTL
BM4_AAGGAGTCTGTA	cDC
BM4_AAGGATTATACT	Prog
BM4_AAGGCAAGACAG	Plasma
BM4_AAGGCCAAGCCG	cDC
BM4_AAGGCCTCGGTT	Prog
BM4_AAGGCGTTCTGN	ProMono
BM4_AAGGGAAAGTAG	T
BM4_AAGGGACGCATG	earlyEry
BM4_AAGGGACTGTCG	GMP
BM4_AAGGGAGATATN	cDC
BM4_AAGGGTCATTCA	GMP
BM4_AAGGGTGTTCCN	T
BM4_AAGGTAATTGAN	ProMono
BM4_AAGGTACCGCTA	T
BM4_AAGGTAGCACAN	T
BM4_AAGGTCAAGCCT	NK
BM4_AAGGTCTTGTAT	earlyEry
BM4_AAGGTGCACTGN	Mono
BM4_AAGGTTCCCCTT	Prog
BM4_AAGTAAACATGG	CTL
BM4_AAGTAATCCGCC	Prog
BM4_AAGTACCAGTAN	Prog
BM4_AAGTACCGTACN	ProMono
BM4_AAGTATCACTAA	Mono
BM4_AAGTATTCATTA	cDC
BM4_AAGTCGTTCTAG	T
BM4_AAGTCTAGGTAC	NK
BM4_AAGTGCGTAAAN	T
BM4_AAGTGTAAAGGC	lateEry
BM4_AAGTGTATTTGC	Prog
BM4_AAGTTAGCCTAA	earlyEry
BM4_AAGTTAGTTTGT	T
BM4_AAGTTCAGGCGA	Mono
BM4_AAGTTCCTGCAN	T
BM4_AAGTTTCCTTAT	T
BM4_AAGTTTGGGAAG	earlyEry
BM4_AATAAAACTCCG	ProMono
BM4_AATAACCGAAAG	T
BM4_AATAACGTCCAC	earlyEry
BM4_AATAAGACTCAN	NK
BM4_AATAAGTGGGAN	cDC
BM4_AATAATGTTGAT	T
BM4_AATACCCGGGTT	Prog
BM4_AATAGAAAGCAN	Mono
BM4_AATAGTGGGAGT	CTL
BM4_AATATATAGCCG	Prog
BM4_AATATGCGCAGC	ProMono
BM4_AATATGTACGCT	Plasma
BM4_AATCAAACACAA	GMP
BM4_AATCAAGTCATG	GMP
BM4_AATCAATACTTN	GMP
BM4_AATCACTCCACA	earlyEry
BM4_AATCAGGCCAGC	B
BM4_AATCCAACAGGG	GMP
BM4_AATCCCTGAACA	B
BM4_AATCCGAACACN	Mono
BM4_AATCCGTGACCN	ProMono
BM4_AATCCTGGAAGA	pDC
BM4_AATCCTTTCCCA	GMP
BM4_AATCGCTCGCAC	GMP
BM4_AATCGTAAGCCG	Prog
BM4_AATCTTCTGATN	earlyEry
BM4_AATGACGAGATN	T
BM4_AATGCCCGTGTN	earlyEry
BM4_AATGCGGTCGTT	Mono
BM4_AATGCTATTGCT	CTL
BM4_AATGGCGGTGTC	lateEry
BM4_AATGTCGCCGAT	T
BM4_AATGTCTCTAAN	T
BM4_AATGTTGCAACC	T
BM4_AATTAATGCGAG	Prog
BM4_AATTACATATCN	earlyEry
BM4_AATTACCCCCGG	GMP
BM4_AATTATCTTGAN	GMP
BM4_AATTCAATCATG	GMP
BM4_AATTCACTATTG	earlyEry
BM4_AATTCAGCCATT	B
BM4_AATTCATTGCCC	earlyEry
BM4_AATTCGGACTCN	cDC
BM4_AATTCTAGATTT	Mono
BM4_AATTCTCAGTCN	T
BM4_AATTCTTCTCAA	Mono
BM4_AATTGAAACTTA	GMP
BM4_AATTGCCACGGT	T
BM4_AATTGCGCTGGC	Prog
BM4_AATTGGATACTN	CTL
BM4_AATTGTTACGGN	earlyEry
BM4_AATTGTTTGCTT	CTL
BM4_AATTTAACCTGA	NK
BM4_AATTTAACTGCG	CTL
BM4_AATTTACAATTA	ProMono
BM4_AATTTACTGCAA	earlyEry
BM4_AATTTATGATCG	GMP
BM4_AATTTCGCTGAG	ProMono
BM4_AATTTGGGTCTT	lateEry
BM4_AATTTTCTCTGG	cDC
BM4_AATTTTGGGCGC	GMP
BM4_AATTTTTACCGN	ProMono
BM4_AATTTTTTGAAC	ProMono
BM4_ACAAACGTGTAG	ProMono
BM4_ACAAAGGGCAGT	earlyEry
BM4_ACAAATGGGCCN	ProMono
BM4_ACAACAATGGGN	ProMono
BM4_ACAACATTGGAA	T
BM4_ACAACGCGCCCC	earlyEry
BM4_ACAACGCTGGAG	Plasma
BM4_ACAACTAGTAAA	CTL
BM4_ACAACTCCCGAC	ProMono
BM4_ACAAGATCCCGN	earlyEry
BM4_ACAAGGGACAGG	earlyEry
BM4_ACAAGGGCGTCT	T
BM4_ACAAGGTCGCAC	T
BM4_ACAAGTCGGGTC	GMP
BM4_ACAAGTGCAAAG	T
BM4_ACAATACCATAG	B
BM4_ACAATACTTCGN	T
BM4_ACAATCCGCAGG	lateEry
BM4_ACAATGACGGCA	CTL
BM4_ACAATGCCCGTT	ProMono
BM4_ACAATGCTGAGG	Mono
BM4_ACAATTATCTGA	T
BM4_ACAATTCGTGCT	T
BM4_ACACATCGATTA	T
BM4_ACACCAGCTCGC	ProMono
BM4_ACACCATGATAA	cDC
BM4_ACACCCTGTCAG	Mono
BM4_ACACGAGAGCCT	T
BM4_ACACGCTGGTTN	ProMono
BM4_ACACTATCATAC	T
BM4_ACAGCTTGACAN	ProMono
BM4_ACAGGCTATGTN	earlyEry
BM4_ACAGGGTGCGTA	Plasma
BM4_ACAGGTAGTTCG	lateEry
BM4_ACAGGTTTTCTC	B
BM4_ACAGTAAGGGCG	GMP
BM4_ACAGTCCCGTGN	earlyEry
BM4_ACAGTCTCAAAN	ProMono
BM4_ACAGTCTCTACN	Mono
BM4_ACAGTGCTTGTT	ProMono
BM4_ACAGTTCTCAAA	Mono
BM4_ACAGTTTCCTCG	ProMono
BM4_ACATAGTTTCTT	GMP
BM4_ACATCATTCGAN	earlyEry
BM4_ACATCCAGATGN	lateEry
BM4_ACATCCCAAGGN	lateEry
BM4_ACATCCGAGGCA	cDC
BM4_ACATGAAGGCAC	CTL
BM4_ACATGCAATTCC	T
BM4_ACATTACGGCAT	GMP
BM4_ACATTATCGCCA	earlyEry
BM4_ACATTCAATAGG	cDC
BM4_ACATTCCAGATG	lateEry
BM4_ACATTCCCAACG	Mono
BM4_ACATTCTAGTAA	earlyEry
BM4_ACATTTGGCCCN	T
BM4_ACCAACGATCGN	T
BM4_ACCAAGACCACN	GMP
BM4_ACCAAGTCACTC	pDC
BM4_ACCAATGATGAA	earlyEry
BM4_ACCACAACATTT	ProMono
BM4_ACCACCGAGAGC	earlyEry
BM4_ACCACCTAAGAT	earlyEry
BM4_ACCACGCACTGT	Mono
BM4_ACCACGGGTCGA	Mono
BM4_ACCACGGTGAAN	ProMono
BM4_ACCACTAACTAT	cDC
BM4_ACCACTCGATTN	CTL
BM4_ACCAGAGGCTCC	ProMono
BM4_ACCAGGCTATGT	earlyEry
BM4_ACCAGGGTGAAT	Mono
BM4_ACCATTGAGCAT	T
BM4_ACCCAGTAGGTA	GMP
BM4_ACCCCAGCCGGT	NK
BM4_ACCCCAGGCTAA	lateEry
BM4_ACCCCCCGAGAN	T
BM4_ACCCGATAAGTC	GMP
BM4_ACCCGGAACGGA	Prog
BM4_ACCCGGCTGCAN	Prog
BM4_ACCCGTCAGGTT	T
BM4_ACCCGTCTCAGC	CTL
BM4_ACCCGTGAAACC	earlyEry
BM4_ACCCTCGGATAT	ProMono
BM4_ACCGAAATGTTA	T
BM4_ACCGCAGCAGCC	ProMono
BM4_ACCGGATAAATC	ProMono
BM4_ACCGTCCGATAC	T
BM4_ACCGTCGATTGC	earlyEry
BM4_ACCGTGACACCC	ProMono
BM4_ACCGTGACCTCC	Mono
BM4_ACCGTGATATTG	Mono
BM4_ACCGTTAAGTTT	NK
BM4_ACCGTTAGCCCC	Prog
BM4_ACCGTTTTTGTA	CTL
BM4_ACCTAGACGCAN	ProB
BM4_ACCTCCCTTTAN	ProMono
BM4_ACCTCTTTCCGA	T
BM4_ACCTGCCTTGGC	ProMono
BM4_ACCTGGTGCTTC	T
BM4_ACCTTTCGGGCN	ProB
BM4_ACGAAACCACCG	earlyEry
BM4_ACGAAGGTTATN	Prog
BM4_ACGAATGCGCCT	T
BM4_ACGAATGCTCTT	lateEry
BM4_ACGACACGGGCT	T
BM4_ACGACCACGTTT	T
BM4_ACGAGCCCCCCT	Prog
BM4_ACGAGCGATCAG	GMP
BM4_ACGAGCGGGCCA	Prog
BM4_ACGAGGAAGAGN	ProMono
BM4_ACGAGTTCAGTG	GMP
BM4_ACGATCATCTGN	CTL
BM4_ACGATCGGCTGA	ProMono
BM4_ACGATTCCATCT	ProMono
BM4_ACGATTTGTTGN	T
BM4_ACGCAATCGTAG	earlyEry
BM4_ACGCAATTTCAC	ProB
BM4_ACGCACGAGCCC	Prog
BM4_ACGCAGCCTACA	T
BM4_ACGCATAAGTAG	earlyEry
BM4_ACGCCTCCACAA	Mono
BM4_ACGCCTCCACGN	lateEry
BM4_ACGCGAGCACAA	earlyEry
BM4_ACGCGATTCGGN	Prog
BM4_ACGCGCCATGAT	Prog
BM4_ACGCGCGCTCCN	earlyEry
BM4_ACGCGGAAGACC	B
BM4_ACGCGTCATGCG	Prog
BM4_ACGCGTGGCAAC	ProMono
BM4_ACGCTAGGCGAA	earlyEry
BM4_ACGCTCCTAGGN	Mono
BM4_ACGCTGAATCTT	GMP
BM4_ACGCTGGTTAGA	HSC
BM4_ACGCTGTATTGN	ProMono
BM4_ACGCTTCTTCTG	pDC
BM4_ACGCTTGTTGGG	Prog
BM4_ACGGAAGGATAT	CTL
BM4_ACGGAATGTCCG	Mono
BM4_ACGGACGAGCAN	B
BM4_ACGGATTGTAGN	GMP
BM4_ACGGCGCCCAGC	GMP
BM4_ACGGCGCGCTCC	earlyEry
BM4_ACGGCGTCCCGA	ProMono
BM4_ACGGCTTAGCCA	NK
BM4_ACGGGATATCTT	lateEry
BM4_ACGGGGCATGAA	lateEry
BM4_ACGGGTAGTCGC	Plasma
BM4_ACGGGTCGAGAN	Prog
BM4_ACGGTAATCCCC	earlyEry
BM4_ACGGTATCACAA	B
BM4_ACGGTCCGTCCN	ProMono
BM4_ACGGTCGCGTTT	CTL
BM4_ACGGTCGTATTC	NK
BM4_ACGGTCTGGGCG	GMP
BM4_ACGTAATATGGT	ProB
BM4_ACGTAGGCTAGT	ProB
BM4_ACGTCATCTTAT	earlyEry
BM4_ACGTCGAGCTAG	Mono
BM4_ACGTGACTAGGA	HSC
BM4_ACGTGATAAGAG	CTL
BM4_ACGTGCCGGTTT	ProMono
BM4_ACGTGCCTGCTA	cDC
BM4_ACGTGCGTAGTT	cDC
BM4_ACGTGGAGGTTC	earlyEry
BM4_ACGTGGTGACCN	ProMono
BM4_ACGTGTAATGCN	Prog
BM4_ACGTTAGACTGT	lateEry
BM4_ACGTTCGTTCCN	ProMono
BM4_ACGTTCTCTTGG	NK
BM4_ACTACAGCAGGT	Prog
BM4_ACTACTGTCCCA	B
BM4_ACTACTTGGGAA	ProMono
BM4_ACTAGCAGGTTA	T
BM4_ACTAGGAAGGTN	ProMono
BM4_ACTATAAGTCGG	GMP
BM4_ACTATAGCGATT	Prog
BM4_ACTATCAAGTCN	GMP
BM4_ACTATCTTAGGT	Prog
BM4_ACTCAAACGGAN	earlyEry
BM4_ACTCAATTACCT	ProMono
BM4_ACTCACGGTTAN	GMP
BM4_ACTCAGGGAAGN	cDC
BM4_ACTCAGGTTAAC	CTL
BM4_ACTCAGTGCATT	Mono
BM4_ACTCCCATTTGN	T
BM4_ACTCCCTGCTTT	lateEry
BM4_ACTCCGCGGCTC	T
BM4_ACTCCGGTTAAN	ProMono
BM4_ACTCTCGCGGCN	lateEry
BM4_ACTCTCGTCGGC	lateEry
BM4_ACTGAAAAGCAN	ProMono
BM4_ACTGAATTATGA	T
BM4_ACTGACTAGCCT	T
BM4_ACTGAGCAGTTC	Mono
BM4_ACTGCAGTCTCC	T
BM4_ACTGCATTGGCT	ProMono
BM4_ACTGGGCTGCAN	ProB
BM4_ACTGGTGATGGT	earlyEry
BM4_ACTGGTGGCCTN	T
BM4_ACTGGTTGGTCG	Mono
BM4_ACTGTCCATGTN	T
BM4_ACTGTTAGCGTG	earlyEry
BM4_ACTGTTGCAGTA	NK
BM4_ACTGTTGGAGTC	T
BM4_ACTGTTGTTACC	earlyEry
BM4_ACTGTTTAGCGT	CTL
BM4_ACTTAAAATGTT	T
BM4_ACTTAGGGTGCC	T
BM4_ACTTAGGTGCTG	Prog
BM4_ACTTATCAAGCN	GMP
BM4_ACTTATCAAGTC	GMP
BM4_ACTTCGTCGCAC	Mono
BM4_ACTTCTCGCGTC	ProMono
BM4_ACTTCTGTAAGN	GMP
BM4_ACTTGAAGGAGN	earlyEry
BM4_ACTTGTAGGCGN	GMP
BM4_ACTTGTGGCAGC	Prog
BM4_ACTTTAGGCAGT	ProB
BM4_ACTTTATTTATA	Mono
BM4_ACTTTCGTATAC	lateEry
BM4_ACTTTCTCCCAG	CTL
BM4_ACTTTTTGTATA	earlyEry
BM4_AGAAAACATATT	lateEry
BM4_AGAAACGCGGTT	Prog
BM4_AGAAACGTCCCC	Prog
BM4_AGAAAGAATCTN	Prog
BM4_AGAAAGACTTCC	CTL
BM4_AGAAAGATTTTA	Mono
BM4_AGAACACTGCGA	ProB
BM4_AGAACCTCTGTA	earlyEry
BM4_AGAACCTCTTGT	cDC
BM4_AGAACGGAATCC	T
BM4_AGAACGGCGTAN	Mono
BM4_AGAACTGCTTGG	CTL
BM4_AGAACTTATTTN	GMP
BM4_AGAAGACCCTAN	pDC
BM4_AGAAGAGGCAGN	ProMono
BM4_AGAAGCAGCTTA	ProMono
BM4_AGAAGCCGGGAA	earlyEry
BM4_AGAAGCTCCGTA	Prog
BM4_AGAAGGAACGTG	Prog
BM4_AGAAGGCTTGCC	T
BM4_AGAAGTAGCTCN	Prog
BM4_AGAAGTCCATTN	cDC
BM4_AGAAGTCTTCAG	Mono
BM4_AGAAGTCTTTCT	ProB
BM4_AGAAGTGGGCCA	earlyEry
BM4_AGAAGTGGTTCN	GMP
BM4_AGAAGTGGTTTC	GMP
BM4_AGAATCGCGGAG	GMP
BM4_AGACAACCGTGC	ProB
BM4_AGACAAGGCTAG	earlyEry
BM4_AGACAGTGTGGN	earlyEry
BM4_AGACCATTGATN	T
BM4_AGACCCGAATGN	earlyEry
BM4_AGACCCGGAGCA	earlyEry
BM4_AGACCGTCAGTN	earlyEry
BM4_AGACCGTTCAGT	earlyEry
BM4_AGACCTTTCGAC	T
BM4_AGACGACTTGTC	Prog
BM4_AGACGCATCTCA	T
BM4_AGACGCTAGGAA	NK
BM4_AGACGCTTGTTG	GMP
BM4_AGACGGGCCGCN	Plasma
BM4_AGACGTGTAGCA	NK
BM4_AGACGTTTTCGG	Mono
BM4_AGACTCACTTCA	Prog
BM4_AGACTCGTTGAG	GMP
BM4_AGACTGTAAGAC	T
BM4_AGACTTATCGCN	earlyEry
BM4_AGAGAGTAAGTA	ProMono
BM4_AGAGAGTGTAGC	T
BM4_AGAGATCGGCGN	ProMono
BM4_AGAGCATCCTCT	Prog
BM4_AGAGCCATCATC	ProMono
BM4_AGAGCTAGCTGA	earlyEry
BM4_AGAGCTTATCGC	earlyEry
BM4_AGAGGCACCGTN	T
BM4_AGAGGTACGGGA	CTL
BM4_AGAGTAGACGAA	earlyEry
BM4_AGAGTCATTAAC	GMP
BM4_AGAGTCCCGAAT	T
BM4_AGAGTGCACGAA	GMP
BM4_AGAGTGCAGACG	B
BM4_AGAGTGTAGTTA	T
BM4_AGAGTTAATAGG	earlyEry
BM4_AGATACACGTGT	earlyEry
BM4_AGATCACGAGAC	CTL
BM4_AGATCCGACTCA	ProMono
BM4_AGATCTAAGCTA	cDC
BM4_AGATCTCTGTTA	ProMono
BM4_AGATGCGAAAGT	T
BM4_AGATGGAGAGTN	Mono
BM4_AGATGGGTCGAC	T
BM4_AGATGGGTTGTG	Mono
BM4_AGATGTAGGAGN	earlyEry
BM4_AGATTCCAGGCC	earlyEry
BM4_AGATTCGCATAT	earlyEry
BM4_AGATTTACTGTN	pDC
BM4_AGATTTTGTTAN	earlyEry
BM4_AGCAAACGCCCN	ProMono
BM4_AGCAAACGCCTC	Mono
BM4_AGCAAGACCTCG	CTL
BM4_AGCAAGCAAAAG	Plasma
BM4_AGCAAGTCAACN	T
BM4_AGCAATCGACTN	lateEry
BM4_AGCACATTCGCC	GMP
BM4_AGCACCGTGTTA	Plasma
BM4_AGCACCTCTAGG	earlyEry
BM4_AGCACGCATAAN	ProMono
BM4_AGCACGGCAGTG	cDC
BM4_AGCACTCATCAG	NK
BM4_AGCACTCCCTGA	B
BM4_AGCAGACCAGAT	T
BM4_AGCAGCCTAGCG	GMP
BM4_AGCAGCCTCTGG	GMP
BM4_AGCAGCTAGGCT	NK
BM4_AGCAGGCGACCG	T
BM4_AGCAGGGTGCAA	Mono
BM4_AGCAGTATTCTT	T
BM4_AGCAGTGTTAGA	Prog
BM4_AGCATTGGTAGA	T
BM4_AGCCAAGAGACC	NK
BM4_AGCCACAAGTTC	lateEry
BM4_AGCCACAGTGAG	ProMono
BM4_AGCCACGCAATN	ProMono
BM4_AGCCAGTATGCC	cDC
BM4_AGCCATGAAACG	B
BM4_AGCCCGCTGCGN	Mono
BM4_AGCCGATCAGGT	T
BM4_AGCCGCATCGTT	lateEry
BM4_AGCCGGAGTTTG	earlyEry
BM4_AGCCTAGACTCN	NK
BM4_AGCCTCATCCTC	pDC
BM4_AGCCTCGTAGCT	T
BM4_AGCCTCTTGCTA	Mono
BM4_AGCCTGCTACAT	Prog
BM4_AGCCTGTGGGCA	ProMono
BM4_AGCGAGACTTAA	GMP
BM4_AGCGCAGTGTGA	T
BM4_AGCGGATGGTGT	ProMono
BM4_AGCGGCCGGCAN	pDC
BM4_AGCGGCTATTTA	T
BM4_AGCGGGGTATTN	Prog
BM4_AGCGTCATGTCA	cDC
BM4_AGCGTCGTCAGT	GMP
BM4_AGCGTGCCCCTN	ProMono
BM4_AGCGTTTGGCAN	cDC
BM4_AGCTAACTCTCG	NK
BM4_AGCTACTACTGC	ProMono
BM4_AGCTAGCGAGGC	earlyEry
BM4_AGCTAGGTGCGA	earlyEry
BM4_AGCTAGTCGGGA	Prog
BM4_AGCTCCGCCCTC	ProB
BM4_AGCTGCCCATTG	ProMono
BM4_AGCTTACTCCGG	ProMono
BM4_AGCTTATGACGA	Prog
BM4_AGCTTATGAGAG	Prog
BM4_AGCTTCAGCCAA	cDC
BM4_AGGAAAGGATTG	GMP
BM4_AGGAAGCGCCTC	Prog
BM4_AGGACGGCCGTN	ProB
BM4_AGGACGTATCAC	CTL
BM4_AGGACGTTAGGC	cDC
BM4_AGGACTACACTC	GMP
BM4_AGGACTAGGCCC	pDC
BM4_AGGAGCCGGAAN	T
BM4_AGGAGCGCAAAC	Prog
BM4_AGGAGCGGAGTG	ProMono
BM4_AGGAGGTGGTAC	Prog
BM4_AGGATGACCCCC	cDC
BM4_AGGATTACACTG	earlyEry
BM4_AGGATTCCCACA	Prog
BM4_AGGCAAAGTTTT	Mono
BM4_AGGCAATGGCAC	cDC
BM4_AGGCAATGGGCG	Prog
BM4_AGGCAGTGTCGC	GMP
BM4_AGGCATCCCTAN	cDC
BM4_AGGCATTTATCT	T
BM4_AGGCCAGGAGGN	CTL
BM4_AGGCCAGTAACA	GMP
BM4_AGGCCCGACTGN	lateEry
BM4_AGGCCGCGACAG	ProB
BM4_AGGCCTCTTGAG	Mono
BM4_AGGCCTGCACTN	T
BM4_AGGCGCATAGGG	ProMono
BM4_AGGCGCATTCGN	CTL
BM4_AGGCGGCATATG	GMP
BM4_AGGCGGCGGTCT	ProMono
BM4_AGGCGGCGTGCT	pDC
BM4_AGGCGTGCGTCA	T
BM4_AGGCTATAGCTN	T
BM4_AGGCTCAGCTAT	NK
BM4_AGGCTCCAGCGN	B
BM4_AGGGAAATGGTA	Prog
BM4_AGGGAATACCGA	Prog
BM4_AGGGATCAAGGA	T
BM4_AGGGATTGGTCC	earlyEry
BM4_AGGGCCTGATAG	earlyEry
BM4_AGGGCGTAAGTN	ProMono
BM4_AGGGCGTCAATC	lateEry
BM4_AGGGGCTTGCCA	GMP
BM4_AGGGGTCGACGG	earlyEry
BM4_AGGGGTTGCTCG	GMP
BM4_AGGGTCACTATT	NK
BM4_AGGGTCCCCTAG	ProMono
BM4_AGGGTCTCTTGN	Mono
BM4_AGGTAAGTCGCN	ProB
BM4_AGGTATAAAGTT	cDC
BM4_AGGTATAGCTGC	T
BM4_AGGTCAGAAAAN	cDC
BM4_AGGTCGAACCAT	Mono
BM4_AGGTCGCGTTAN	T
BM4_AGGTCGCTTTAT	T
BM4_AGGTCGGCGATN	T
BM4_AGGTCGTGCAGC	earlyEry
BM4_AGGTCTCTACTG	Mono
BM4_AGGTGAGTGGAA	T
BM4_AGGTGCGCTGTT	GMP
BM4_AGGTGTCAGAGG	Mono
BM4_AGGTGTGTCATA	ProMono
BM4_AGGTTAGCGGTC	earlyEry
BM4_AGGTTATCTCGT	Prog
BM4_AGGTTGATCTAN	ProMono
BM4_AGGTTGTACACT	ProMono
BM4_AGGTTTACAGGN	T
BM4_AGGTTTAGGTTN	ProB
BM4_AGGTTTCCCGAC	B
BM4_AGTAACCGGAAA	Prog
BM4_AGTAAGTTGCCN	GMP
BM4_AGTACATACTCT	NK
BM4_AGTACATTGAAG	GMP
BM4_AGTACGAAAGTG	Prog
BM4_AGTATTGGCGGN	Mono
BM4_AGTCAACAGCCG	cDC
BM4_AGTCAACAGGAC	T
BM4_AGTCACAGAGGN	earlyEry
BM4_AGTCAGCTCAGG	ProMono
BM4_AGTCAGTCTGCC	GMP
BM4_AGTCATCGCCAC	cDC
BM4_AGTCCCTGGCCT	NK
BM4_AGTCCGCTGTGG	Mono
BM4_AGTCCTATTATA	Mono
BM4_AGTCGAAGGTAN	Prog
BM4_AGTCGAGGCCAG	ProMono
BM4_AGTCGATATGTT	T
BM4_AGTCGGAAAGTT	Prog
BM4_AGTCGTGTTGGA	NK
BM4_AGTCGTTAACCC	T
BM4_AGTCTAACTAGC	ProMono
BM4_AGTCTCATAAAN	Prog
BM4_AGTCTTTGCACC	ProMono
BM4_AGTGAAGAAACT	cDC
BM4_AGTGAGGACTTC	Mono
BM4_AGTGAGGGTCAN	Prog
BM4_AGTGATGGTCTN	Mono
BM4_AGTGCTCATTCT	ProB
BM4_AGTGCTTACATC	cDC
BM4_AGTGGACGAAGG	Mono
BM4_AGTGGCGTGTCN	Prog
BM4_AGTGGCTGGAGN	NK
BM4_AGTGGTCGTATA	B
BM4_AGTGTCAAGGTT	Mono
BM4_AGTGTCGTTCGT	T
BM4_AGTGTGAGGTGC	earlyEry
BM4_AGTGTGTGTACA	ProMono
BM4_AGTGTTATCACN	CTL
BM4_AGTGTTGGAGAT	ProB
BM4_AGTGTTTACTCT	earlyEry
BM4_AGTTAGCGCGGA	ProMono
BM4_AGTTAGTGTAGN	T
BM4_AGTTATCAATGA	ProMono
BM4_AGTTCCCATCAN	Prog
BM4_AGTTCTCGCGGT	cDC
BM4_AGTTGGCCTGTT	ProMono
BM4_AGTTGGGCGTGA	Mono
BM4_AGTTTCATGTTG	ProMono
BM4_AGTTTGCGAGTC	Mono
BM4_AGTTTGTTTCAG	Prog
BM4_AGTTTTGAACCC	GMP
BM4_AGTTTTTAAGCC	T
BM4_ATAAAAGATCGC	GMP
BM4_ATAAAGAAGTAC	GMP
BM4_ATAAAGACCCAT	T
BM4_ATAAAGGGTCGN	Prog
BM4_ATAAATCTGTTG	CTL
BM4_ATAAATTGAGTN	Prog
BM4_ATAACAAAGGAC	T
BM4_ATAAGAGCGTTN	pDC
BM4_ATAAGCTGATAN	CTL
BM4_ATAAGTCCATGT	cDC
BM4_ATAATATTGGCT	CTL
BM4_ATAATCGCGTGN	earlyEry
BM4_ATAATTCACACA	T
BM4_ATACAACCAGCG	GMP
BM4_ATACAAGATAAN	NK
BM4_ATACACCATACN	earlyEry
BM4_ATACAGTAGAGC	T
BM4_ATACCGAAGCTT	T
BM4_ATACCGCAGCGA	earlyEry
BM4_ATACCTACATGA	CTL
BM4_ATACCTCTGGCG	Prog
BM4_ATACGACACCGN	ProB
BM4_ATACGCTTACGA	earlyEry
BM4_ATACGTCGCGTC	Mono
BM4_ATACGTTATACN	ProMono
BM4_ATACTTAGTATT	lateEry
BM4_ATAGAACCAGAA	Mono
BM4_ATAGAGATTTAG	Prog
BM4_ATAGAGGCGGAT	Prog
BM4_ATAGAGGTCAAG	pDC
BM4_ATAGCACTGGCG	Prog
BM4_ATAGCCCATACG	earlyEry
BM4_ATAGCCGCTTAN	CTL
BM4_ATAGCGCCAAAT	Mono
BM4_ATAGCGGTAGTT	Mono
BM4_ATAGGACAGAAA	Mono
BM4_ATAGGAGGATAG	GMP
BM4_ATAGGCACAGGA	Mono
BM4_ATAGGTCTTGGA	earlyEry
BM4_ATAGTAAGCACN	CTL
BM4_ATAGTAAGCAGN	T
BM4_ATAGTACTATGG	earlyEry
BM4_ATAGTTCAAACT	Mono
BM4_ATAGTTGAGTGT	Prog
BM4_ATATACGGGTTN	GMP
BM4_ATATAGGGGATA	lateEry
BM4_ATATATACATGA	ProMono
BM4_ATATCAAAGGCC	Prog
BM4_ATATGCAGCCAT	T
BM4_ATATGCTGGGGC	Mono
BM4_ATATGGGTGAGN	ProMono
BM4_ATATGTCCTACN	CTL
BM4_ATATTACCTGAC	T
BM4_ATATTAGGAGTN	Prog
BM4_ATATTCGCTCTA	cDC
BM4_ATATTCTGACGT	T
BM4_ATATTGTTGCTT	T
BM4_ATATTTTTATGA	T
BM4_ATCAAAGGATAC	earlyEry
BM4_ATCAACTGCGGT	lateEry
BM4_ATCAAGAGAGTC	Mono
BM4_ATCAAGTGTAGC	ProMono
BM4_ATCACAAGATCC	Mono
BM4_ATCACATGGTAN	B
BM4_ATCACCCATGGN	GMP
BM4_ATCACCTAGGCN	T
BM4_ATCACGCCGTCT	lateEry
BM4_ATCACTGTCCAC	GMP
BM4_ATCACTGTCCTA	ProB
BM4_ATCAGAATAGTC	cDC
BM4_ATCAGCAGGCTT	ProMono
BM4_ATCAGTCGAATT	B
BM4_ATCAGTTTATTA	ProMono
BM4_ATCATCACTTGC	B
BM4_ATCATTCCAACA	T
BM4_ATCATTCCGACG	T
BM4_ATCATTTAAGTG	Mono
BM4_ATCATTTTGGAA	T
BM4_ATCCAGCTGGCG	GMP
BM4_ATCCAGTTAGCN	GMP
BM4_ATCCCGGACAAG	cDC
BM4_ATCCCGTCATAA	NK
BM4_ATCCGCCCGTGA	T
BM4_ATCCGCCGGAGT	cDC
BM4_ATCCGCCGTTAA	CTL
BM4_ATCCGCGCAGCA	cDC
BM4_ATCCGTCTGGAC	T
BM4_ATCCGTTATCCG	CTL
BM4_ATCCTATTCGAA	T
BM4_ATCCTCCAGAGN	Mono
BM4_ATCCTCCTAGAG	Mono
BM4_ATCCTGCTTGGT	T
BM4_ATCGAAAGGGGT	lateEry
BM4_ATCGAATTACGN	CTL
BM4_ATCGACGAGGCA	HSC
BM4_ATCGCGTCTGAA	ProMono
BM4_ATCGCGTGTGTN	Mono
BM4_ATCGGATTAGAN	Prog
BM4_ATCGTAGTAGGT	earlyEry
BM4_ATCGTCGTAGCT	Prog
BM4_ATCGTCGTGTGT	Mono
BM4_ATCGTGATGGCA	Mono
BM4_ATCGTGCTGGGN	earlyEry
BM4_ATCGTTGTTTTN	lateEry
BM4_ATCGTTTGTTTT	lateEry
BM4_ATCTAATAGGGT	T
BM4_ATCTAATCACAA	GMP
BM4_ATCTACGGCTTA	ProB
BM4_ATCTCAGCACGT	Mono
BM4_ATCTCGCTAAAN	earlyEry
BM4_ATCTGAGATCTT	T
BM4_ATCTGGGGGCAN	Prog
BM4_ATCTGTCGCTTA	T
BM4_ATCTTAACAGCC	ProMono
BM4_ATCTTGCACGAT	earlyEry
BM4_ATCTTGCCCCCA	T
BM4_ATCTTGCCGTCG	ProMono
BM4_ATCTTTATTGGT	NK
BM4_ATGAAAAGGGAN	ProMono
BM4_ATGAACGATTTG	cDC
BM4_ATGAAGGGCAGG	pDC
BM4_ATGAGGTGGACC	CTL
BM4_ATGATAGGTCAN	Plasma
BM4_ATGATCATTGCA	ProMono
BM4_ATGATGACCTAN	earlyEry
BM4_ATGATGTTGACT	ProB
BM4_ATGCACCCACCN	Prog
BM4_ATGCCAGCTTCG	T
BM4_ATGCCAGTAGAN	lateEry
BM4_ATGCCCCAAAGG	earlyEry
BM4_ATGCCGGATTGC	NK
BM4_ATGCCTAGAGTA	ProMono
BM4_ATGCGCCAAACG	Mono
BM4_ATGCGCCCTTGG	ProMono
BM4_ATGCGCTATGAG	Plasma
BM4_ATGCGGACGCCA	CTL
BM4_ATGCGGACGGTN	Plasma
BM4_ATGCGTCTCTAN	ProMono
BM4_ATGCTAAAGGAN	T
BM4_ATGCTACAGAGA	GMP
BM4_ATGCTACAGTCG	Mono
BM4_ATGCTAGATCAC	ProMono
BM4_ATGCTCAAAGAG	earlyEry
BM4_ATGCTCACGAGT	T
BM4_ATGCTGCATTGA	CTL
BM4_ATGGAAAGACAG	ProMono
BM4_ATGGAACCTAAN	Mono
BM4_ATGGAACGTAAC	ProMono
BM4_ATGGAATGTCGA	ProMono
BM4_ATGGATAAGACC	Mono
BM4_ATGGATCAGGGC	cDC
BM4_ATGGATGGCCTG	Prog
BM4_ATGGATGTGAGA	CTL
BM4_ATGGATTGGTGN	earlyEry
BM4_ATGGCGAGGTCN	ProMono
BM4_ATGGCTCGTTCN	T
BM4_ATGGGAATATCG	Mono
BM4_ATGGGGAACCAN	GMP
BM4_ATGGGGGACTAA	GMP
BM4_ATGGTACGGTCN	CTL
BM4_ATGGTCTAGCAT	ProMono
BM4_ATGGTGATATAC	Mono
BM4_ATGGTGGTTGTC	ProMono
BM4_ATGGTGTAGTTT	Prog
BM4_ATGGTGTCCTCC	Mono
BM4_ATGGTGTGCAGN	T
BM4_ATGGTTTCAGAG	Prog
BM4_ATGGTTTGCACG	cDC
BM4_ATGTCACGATGN	GMP
BM4_ATGTCACGATTG	GMP
BM4_ATGTCCAGTCCN	ProMono
BM4_ATGTCGGTAAAC	T
BM4_ATGTGAGTTATG	ProB
BM4_ATGTGCATGCCG	earlyEry
BM4_ATGTGGAGTGGA	T
BM4_ATGTGGGAGTGA	T
BM4_ATGTGTAGTTTN	Prog
BM4_ATGTTAAAGCTG	T
BM4_ATGTTCATCATT	ProMono
BM4_ATGTTCCAGTCC	ProMono
BM4_ATGTTGCCGTAG	Prog
BM4_ATGTTGTGATCC	Mono
BM4_ATTAAGCCTTAG	ProMono
BM4_ATTAATTTGAGN	ProMono
BM4_ATTACACTAGAC	Mono
BM4_ATTACGTTGTAN	T
BM4_ATTAGAGGTTGG	T
BM4_ATTAGCTATACT	NK
BM4_ATTAGGGTTACN	GMP
BM4_ATTATTTCGTCC	Mono
BM4_ATTCAAATCCAA	GMP
BM4_ATTCACCAGAGT	earlyEry
BM4_ATTCCACCTTGT	ProMono
BM4_ATTCCACTCCTN	ProMono
BM4_ATTCCCGACTTT	earlyEry
BM4_ATTCCGCAGTCC	ProMono
BM4_ATTCCGGCGTCN	ProMono
BM4_ATTCCTAGTCGN	Plasma
BM4_ATTCGAGTGCGT	earlyEry
BM4_ATTCGGACGTAA	T
BM4_ATTCGGTGATGG	Mono
BM4_ATTCGTCTCATT	earlyEry
BM4_ATTCTCGTGGAN	CTL
BM4_ATTCTCTGATAN	Mono
BM4_ATTCTGTCTCAA	T
BM4_ATTCTTTTATTA	earlyEry
BM4_ATTGATAGGCTA	CTL
BM4_ATTGCGTCGGGT	earlyEry
BM4_ATTGGAATACAC	NK
BM4_ATTGGTAAGATG	NK
BM4_ATTGTAAGATAA	HSC
BM4_ATTGTATAGTAA	ProMono
BM4_ATTGTCTGGATA	T
BM4_ATTGTTTAGGGC	earlyEry
BM4_ATTTATGAGAGA	GMP
BM4_ATTTATTGGCAT	Prog
BM4_ATTTCCAGCGTA	Prog
BM4_ATTTCGTTGGGT	T
BM4_ATTTCTATAGAT	T
BM4_ATTTCTGACGAA	T
BM4_ATTTGGCATTAA	earlyEry
BM4_ATTTGTTAGGCN	NK
BM4_ATTTTAACACAN	CTL
BM4_ATTTTAACATGN	earlyEry
BM4_ATTTTAACCGAA	T
BM4_ATTTTATAGGGT	lateEry
BM4_ATTTTGAATCCT	cDC
BM4_ATTTTGCGACGN	lateEry
BM4_ATTTTGGGCCAC	GMP
BM4_ATTTTGGGTCAN	earlyEry
BM4_ATTTTGTGCTCA	GMP
BM4_ATTTTGTGGCTN	T
BM4_ATTTTTAGGGCN	earlyEry
BM4_CAAAAAGAGCTA	cDC
BM4_CAAAAGAGCTGA	Prog
BM4_CAAAAGCTCAGG	Prog
BM4_CAAAAGGCGGAT	ProMono
BM4_CAAACGACTGAG	earlyEry
BM4_CAAACTCTTTAN	T
BM4_CAAAGCGCTTTC	T
BM4_CAAAGCTTCATT	GMP
BM4_CAAATAGCCATC	Mono
BM4_CAAATGCCTGAG	earlyEry
BM4_CAAATTCGCTTT	ProMono
BM4_CAACAATTCACG	Mono
BM4_CAACATCTTAGA	T
BM4_CAACGACCGATT	cDC
BM4_CAACGCGCTCGT	Prog
BM4_CAACGGATACTA	ProMono
BM4_CAACGTCCGTAN	NK
BM4_CAACTAATCAAA	ProMono
BM4_CAACTCTTGGAC	lateEry
BM4_CAACTTGTGCTA	earlyEry
BM4_CAACTTTAGATG	T
BM4_CAAGAACCAGGT	cDC
BM4_CAAGAAGGAGAN	pDC
BM4_CAAGATTCTGAN	earlyEry
BM4_CAAGCACTCCGA	Mono
BM4_CAAGCCCAGCAN	T
BM4_CAAGCCCCTCGG	ProMono
BM4_CAAGCTGCTGCA	earlyEry
BM4_CAAGGATAGTTA	T
BM4_CAAGTCTACCCG	ProMono
BM4_CAAGTCTTTAGG	T
BM4_CAAGTGGGCTTC	lateEry
BM4_CAAGTTCTGTTC	Prog
BM4_CAAGTTTTGATN	ProMono
BM4_CAATACAAAATC	Mono
BM4_CAATAGCCCGGG	Prog
BM4_CAATGGTGCACG	Prog
BM4_CAATTCGTGGCG	GMP
BM4_CAATTTGTCACN	earlyEry
BM4_CAATTTTGACTC	Prog
BM4_CAATTTTGAGGA	T
BM4_CACAAAGGGATG	ProMono
BM4_CACAAGGGGCAT	Prog
BM4_CACACATAGCAA	Prog
BM4_CACACATCTATG	earlyEry
BM4_CACACATCTCGT	Mono
BM4_CACACGAGACCN	T
BM4_CACACGATGTCG	T
BM4_CACACGGATGAG	cDC
BM4_CACACTGGAAGG	earlyEry
BM4_CACAGCCCATAA	Prog
BM4_CACAGGACCTCN	T
BM4_CACAGGCACGGC	B
BM4_CACAGGCCGACA	T
BM4_CACAGGTTGGTT	Prog
BM4_CACAGTAGGAGT	earlyEry
BM4_CACAGTCACCCN	GMP
BM4_CACAGTGCGGCG	ProMono
BM4_CACAGTTATACN	GMP
BM4_CACATCATCTAC	Prog
BM4_CACATGACGTGC	Mono
BM4_CACATGGTAGGG	Mono
BM4_CACATTATTTAT	T
BM4_CACCAACGATGN	T
BM4_CACCACCACTTN	T
BM4_CACCAGCGGCTG	T
BM4_CACCCTAGCTGN	ProB
BM4_CACCCTATAACA	Mono
BM4_CACCCTCCGGAN	T
BM4_CACCGACGCCCN	GMP
BM4_CACCGTAGACTN	T
BM4_CACCTAGATATA	CTL
BM4_CACCTCGAGTTN	earlyEry
BM4_CACCTGCGACAG	Prog
BM4_CACCTGTCAGGA	T
BM4_CACGACAATGTN	Prog
BM4_CACGCCATCGAG	GMP
BM4_CACGCGCGTTCG	Prog
BM4_CACGCGCTCGTN	Prog
BM4_CACGCGGCTTCG	ProMono
BM4_CACGCGTTTTAG	T
BM4_CACGCTCCGTTN	ProMono
BM4_CACGGATTAACN	earlyEry
BM4_CACGGCAGAACA	GMP
BM4_CACGGCGTTCCC	T
BM4_CACGGGTCAAAG	GMP
BM4_CACGTCAAGTTC	Mono
BM4_CACGTCATGTGN	T
BM4_CACGTGTGATGN	Mono
BM4_CACGTGTTGATG	Mono
BM4_CACTAGAACTGN	cDC
BM4_CACTAGTTTGTA	cDC
BM4_CACTCAGTCCGA	CTL
BM4_CACTCGGGGAAG	earlyEry
BM4_CACTGATCAGCC	Mono
BM4_CACTGTTGGCGC	Plasma
BM4_CACTTTGAGATG	Plasma
BM4_CACTTTGTAGTT	B
BM4_CACTTTTACACT	ProMono
BM4_CACTTTTGCGGN	ProMono
BM4_CAGAACGTGGTT	Prog
BM4_CAGAAGATCAAT	CTL
BM4_CAGAATGATGGN	GMP
BM4_CAGACAAGATAN	T
BM4_CAGACACAAGGG	Mono
BM4_CAGACCGTGGAC	cDC
BM4_CAGACTGCAAGN	Mono
BM4_CAGACTGGAGTC	T
BM4_CAGAGCCTACGT	T
BM4_CAGAGGTAGGGA	CTL
BM4_CAGATACCGTTT	Prog
BM4_CAGATAGAATTG	GMP
BM4_CAGATGGGTCTC	Prog
BM4_CAGATTCGGCCT	cDC
BM4_CAGATTTTCTGN	Prog
BM4_CAGCAAACGTTC	earlyEry
BM4_CAGCACGACTTT	Mono
BM4_CAGCAGCGGGTG	Mono
BM4_CAGCATGGCTCG	T
BM4_CAGCCCTAACAC	earlyEry
BM4_CAGCCGGCTACN	ProB
BM4_CAGCCGTCGTTA	T
BM4_CAGCGAATTGGA	Mono
BM4_CAGCGCAACTTC	cDC
BM4_CAGGAAAGAACT	Prog
BM4_CAGGAATCGGTG	Prog
BM4_CAGGACTCCTCA	Prog
BM4_CAGGACTCTCAN	Prog
BM4_CAGGAGGATTCG	T
BM4_CAGGCAACGGCT	ProMono
BM4_CAGGCCGCTAAN	T
BM4_CAGGGAAGTGTN	cDC
BM4_CAGGGACAGTGG	T
BM4_CAGGGAGAGGAT	earlyEry
BM4_CAGGGCATGGAG	T
BM4_CAGGTAGAACGN	ProMono
BM4_CAGGTCTTCCAA	Mono
BM4_CAGGTGCTCGTT	Mono
BM4_CAGGTGTGTAAN	NK
BM4_CAGGTTCGTCCN	Prog
BM4_CAGGTTCTTACT	ProMono
BM4_CAGGTTTTTGAT	Mono
BM4_CAGTAATTCCCT	Mono
BM4_CAGTACGTGCTA	earlyEry
BM4_CAGTATGTGATG	Prog
BM4_CAGTCCACTTGT	earlyEry
BM4_CAGTCTTCCAAN	Mono
BM4_CAGTGGATAAAG	cDC
BM4_CAGTGGCTGACN	earlyEry
BM4_CAGTGGCTTGAG	T
BM4_CAGTGGGCTGCG	cDC
BM4_CAGTGTCCAGGT	NK
BM4_CAGTGTGCATCC	Mono
BM4_CAGTGTTAGACA	earlyEry
BM4_CAGTGTTTCGTG	T
BM4_CAGTTAACTCCN	ProMono
BM4_CAGTTAGCTTGA	Plasma
BM4_CAGTTCCCCCAG	CTL
BM4_CAGTTCGCACCT	Prog
BM4_CAGTTGTAAGGA	T
BM4_CAGTTTCCTGCA	Prog
BM4_CATAAAAGGGCG	Mono
BM4_CATAAAGTCTCT	ProMono
BM4_CATAACCCGTAC	ProMono
BM4_CATACCGCATGN	earlyEry
BM4_CATACCTGCATG	earlyEry
BM4_CATAGAATCCGN	lateEry
BM4_CATAGCCGGATC	Mono
BM4_CATAGGTCTTGT	B
BM4_CATAGTTACATG	Mono
BM4_CATATCTCTTTT	T
BM4_CATCAAACTGCG	GMP
BM4_CATCACGTCCTA	ProMono
BM4_CATCAGAACGAN	ProB
BM4_CATCAGCACTAA	earlyEry
BM4_CATCCTTGACTN	T
BM4_CATCGCACCGAC	T
BM4_CATCGCGAGGGC	Prog
BM4_CATCGCTTACTG	Mono
BM4_CATCGCTTAGTC	earlyEry
BM4_CATCTATCGAAC	Prog
BM4_CATCTGGGCATT	T
BM4_CATCTTTATTTC	B
BM4_CATGAACGAGTC	Mono
BM4_CATGAAGGATAN	T
BM4_CATGATGATGAN	cDC
BM4_CATGCCAGCGGT	ProMono
BM4_CATGCCCAGACA	T
BM4_CATGCCGTCAGT	T
BM4_CATGCGGAGACG	GMP
BM4_CATGGCGAACCG	Prog
BM4_CATGGCTGACGG	NK
BM4_CATGTAAGATGT	earlyEry
BM4_CATGTAATCCCA	T
BM4_CATGTCAGACAN	earlyEry
BM4_CATGTCTAGCCG	Mono
BM4_CATGTCTCGTGT	Mono
BM4_CATGTGATCGCA	Prog
BM4_CATTACCGAGGT	Prog
BM4_CATTATCATTAG	T
BM4_CATTCGGAGTAT	Prog
BM4_CATTCTTCAAGG	earlyEry
BM4_CATTGTCAATAT	GMP
BM4_CATTTCATTCGC	CTL
BM4_CATTTCTACGAG	cDC
BM4_CATTTGGTGCCC	T
BM4_CATTTTGGTGAG	ProMono
BM4_CATTTTTACTGT	CTL
BM4_CATTTTTTATAT	T
BM4_CCAAAAAAATGN	Mono
BM4_CCAAAATCAGAC	GMP
BM4_CCAAAGACGTCC	Prog
BM4_CCAAATGCTAAT	T
BM4_CCAAATGGTCCG	T
BM4_CCAACATAACCC	T
BM4_CCAACCGGCAGT	Prog
BM4_CCAACGATCGCT	CTL
BM4_CCAACGCACGTT	B
BM4_CCAAGAACGGAT	lateEry
BM4_CCAAGACGACGN	ProMono
BM4_CCAAGCTCGACT	Mono
BM4_CCAATACGCTTG	Mono
BM4_CCAATGTTCAGG	cDC
BM4_CCAATTATCCGN	T
BM4_CCAATTGCGAGT	Mono
BM4_CCACAGGCCGAT	ProMono
BM4_CCACATCTAGTG	ProMono
BM4_CCACCCTTTATG	lateEry
BM4_CCACCGGCGTGA	CTL
BM4_CCACGCAAGACA	lateEry
BM4_CCACGCAAGCTN	ProMono
BM4_CCACGTATCGAA	lateEry
BM4_CCACGTGCAATG	B
BM4_CCACGTGCCACN	Prog
BM4_CCACGTTGATGN	Plasma
BM4_CCACTAGACCAC	T
BM4_CCAGAGATTTAG	CTL
BM4_CCAGAGTTGCTA	GMP
BM4_CCAGATTTGAGN	ProB
BM4_CCAGCCGAAGGA	Mono
BM4_CCAGGCCTACTG	T
BM4_CCAGGGCGACTC	cDC
BM4_CCAGGGTCTCGA	GMP
BM4_CCAGGTGTCGCA	T
BM4_CCAGTATATAGC	Plasma
BM4_CCAGTGTCTGTG	T
BM4_CCAGTTACATTG	Prog
BM4_CCAGTTGCGCGA	cDC
BM4_CCAGTTTTTCGT	Prog
BM4_CCATCCTGACGG	Prog
BM4_CCATGAACGGTT	ProB
BM4_CCATGAAGCACC	Mono
BM4_CCATGATATAAC	CTL
BM4_CCATGGGGTTGN	lateEry
BM4_CCATTAGGTCTT	Mono
BM4_CCATTAGTATTG	NK
BM4_CCATTCCTGTTN	lateEry
BM4_CCATTCGGAGAT	cDC
BM4_CCATTGTAGATA	CTL
BM4_CCATTTCTGACC	T
BM4_CCCAAAATAATC	Prog
BM4_CCCAAACGAAAT	T
BM4_CCCAACGCGAAT	T
BM4_CCCAAGCTAATA	T
BM4_CCCAAGGATCAA	cDC
BM4_CCCACGTTGCTG	earlyEry
BM4_CCCACTAGTATA	NK
BM4_CCCAGAGGCTGC	T
BM4_CCCATATGCTAA	ProMono
BM4_CCCATGACGGCT	cDC
BM4_CCCCAATATTGG	Prog
BM4_CCCCAATTTGGN	Mono
BM4_CCCCACGTGAGN	ProMono
BM4_CCCCACGTGATG	ProMono
BM4_CCCCCAACGGTN	earlyEry
BM4_CCCCCAATAAAC	lateEry
BM4_CCCCCGTTCAAC	earlyEry
BM4_CCCCCTCAAATC	T
BM4_CCCCGACTAGAA	earlyEry
BM4_CCCCGCCTCCGG	earlyEry
BM4_CCCCGGATAATG	GMP
BM4_CCCCGGTTGGTA	ProMono
BM4_CCCCTCCGTGAT	Prog
BM4_CCCCTTAGCAGG	T
BM4_CCCCTTCTCTCA	GMP
BM4_CCCCTTGGCGTN	T
BM4_CCCGAAGACGTN	cDC
BM4_CCCGAGAGGCTN	GMP
BM4_CCCGATTAGAAC	T
BM4_CCCGCAGCTTTN	GMP
BM4_CCCGCGCGAGAN	ProB
BM4_CCCGCGTTCGGG	earlyEry
BM4_CCCGGAAGAATG	cDC
BM4_CCCGGATGGTGC	ProMono
BM4_CCCGGCATGTCN	ProMono
BM4_CCCGGTAGATCN	cDC
BM4_CCCGGTTCGTTA	CTL
BM4_CCCGGTTGCGAN	earlyEry
BM4_CCCGTAACTGAG	Mono
BM4_CCCGTACTGGAN	NK
BM4_CCCGTAGCGCAG	cDC
BM4_CCCGTGTGTTGC	T
BM4_CCCTACCACCTC	Prog
BM4_CCCTACCATAAG	T
BM4_CCCTAGGCAATC	T
BM4_CCCTAGGCGCTC	B
BM4_CCCTGAATAGAN	ProMono
BM4_CCCTGCAAGAAC	earlyEry
BM4_CCCTGCCGACGT	earlyEry
BM4_CCCTTACCAAGA	Prog
BM4_CCCTTCGGAGAC	GMP
BM4_CCCTTCTATGAN	T
BM4_CCCTTGCCGCAA	cDC
BM4_CCCTTGGTTTGC	T
BM4_CCCTTTTGTGAN	ProB
BM4_CCGAAATCACAN	B
BM4_CCGAACACCGTA	B
BM4_CCGAACCGCGAC	ProMono
BM4_CCGAATCCGGTA	cDC
BM4_CCGACAAACCGC	lateEry
BM4_CCGACAAAGGGA	Prog
BM4_CCGACGAAGGTT	pDC
BM4_CCGACGGCCTTG	T
BM4_CCGACTAGGTGT	CTL
BM4_CCGAGACTAATA	CTL
BM4_CCGAGAGTCGAA	T
BM4_CCGAGCAACTGN	NK
BM4_CCGAGGGCAGTA	earlyEry
BM4_CCGAGTCGGATG	GMP
BM4_CCGATACGCGTG	Mono
BM4_CCGATATCTCAN	earlyEry
BM4_CCGCAAAATGGN	T
BM4_CCGCAAGTGGTC	ProMono
BM4_CCGCACGCGCCA	T
BM4_CCGCAGACACGC	B
BM4_CCGCATTCTGAN	ProMono
BM4_CCGCCAATCTGA	NK
BM4_CCGCCAGCACTN	GMP
BM4_CCGCCCGGTCGA	NK
BM4_CCGCCTATTGCG	T
BM4_CCGCGACTTTAG	Prog
BM4_CCGCGCGCTCAT	ProMono
BM4_CCGCGGCATATT	Mono
BM4_CCGCTATTTCGA	Prog
BM4_CCGCTGCACGCT	T
BM4_CCGCTGGAAGAT	ProB
BM4_CCGCTTAATCTG	ProMono
BM4_CCGGACATTCTC	ProMono
BM4_CCGGACTTCTCN	ProMono
BM4_CCGGAGCTCGGN	Prog
BM4_CCGGAGTACGGT	ProMono
BM4_CCGGAGTCAATG	GMP
BM4_CCGGCAGCGCTT	T
BM4_CCGGCTTCGGGA	Plasma
BM4_CCGGGCCGAGGT	ProMono
BM4_CCGGGCTACACG	ProMono
BM4_CCGGGGCAGCGA	earlyEry
BM4_CCGGGGTGACAG	earlyEry
BM4_CCGGTCTCACAG	Plasma
BM4_CCGGTGAGACCC	Mono
BM4_CCGTACTCTAGC	Mono
BM4_CCGTAGCATCGN	Mono
BM4_CCGTAGTTTCCT	Prog
BM4_CCGTATATTAAN	T
BM4_CCGTCTACCAAT	earlyEry
BM4_CCGTCTACCAGA	T
BM4_CCGTGAGATGAA	Mono
BM4_CCGTGAGCGCCN	ProMono
BM4_CCGTGCGTACCC	earlyEry
BM4_CCGTGCGTCCCN	earlyEry
BM4_CCGTGGAACTGC	earlyEry
BM4_CCGTGGGTCTAN	ProMono
BM4_CCGTTAGAGTGA	earlyEry
BM4_CCGTTAGATGAN	earlyEry
BM4_CCGTTAGTGCAC	Prog
BM4_CCGTTCCACGAG	T
BM4_CCGTTCTGTGGN	cDC
BM4_CCGTTGAGGCTN	lateEry
BM4_CCGTTGATGGCT	lateEry
BM4_CCGTTGGAAACN	GMP
BM4_CCTAAAAAGCAT	earlyEry
BM4_CCTAAAGACTGA	ProMono
BM4_CCTAAAGGACCC	T
BM4_CCTAAGATATTT	Prog
BM4_CCTACAACGGCT	Mono
BM4_CCTACGAGGACG	T
BM4_CCTACGGGTCGA	earlyEry
BM4_CCTACTGACCCA	Mono
BM4_CCTACTTGAGGC	B
BM4_CCTAGATTTGAG	ProB
BM4_CCTAGCGGCGAN	ProMono
BM4_CCTAGGTGGCAC	Mono
BM4_CCTAGTTTCCAT	ProMono
BM4_CCTATCTGTGTT	T
BM4_CCTATTCTGGTN	GMP
BM4_CCTCAAACTTGG	ProMono
BM4_CCTCAAGCCCTG	earlyEry
BM4_CCTCAGAGATCC	T
BM4_CCTCCATTTACN	CTL
BM4_CCTCCGGACCTG	T
BM4_CCTCCGTGATGG	T
BM4_CCTCCTTTATTG	T
BM4_CCTCGTTTGTAG	ProMono
BM4_CCTCTATGTCAC	Mono
BM4_CCTCTTTCTGTG	T
BM4_CCTGAAAATGTC	Prog
BM4_CCTGAGCCGCTA	Mono
BM4_CCTGAGCGGAGN	earlyEry
BM4_CCTGCAATCGAN	lateEry
BM4_CCTGCTACCCCC	Mono
BM4_CCTGCTCCTTCT	cDC
BM4_CCTGGAACGAAN	T
BM4_CCTGGATGTCCC	T
BM4_CCTGGCGGCGTN	HSC
BM4_CCTGGGGCTTGC	ProMono
BM4_CCTGGTTTCTGN	Prog
BM4_CCTGTACAGTTT	ProB
BM4_CCTGTACCTTTC	NK
BM4_CCTGTGCTTTCA	ProMono
BM4_CCTGTGGCTTTG	GMP
BM4_CCTGTTGAGTTT	Prog
BM4_CCTGTTTTTAAC	Mono
BM4_CCTTAACCAATN	T
BM4_CCTTCAAAGTCT	T
BM4_CCTTCGAGAACG	NK
BM4_CCTTCGCGCCGA	ProMono
BM4_CCTTCTATTTAN	GMP
BM4_CCTTCTCAATGN	CTL
BM4_CCTTCTTCTTGA	T
BM4_CCTTGACTACCN	ProMono
BM4_CCTTGAGGGCAA	Mono
BM4_CCTTGCTGTGAA	Prog
BM4_CCTTGTCGGGTC	T
BM4_CCTTTAATCAAN	Mono
BM4_CCTTTCTATTTA	GMP
BM4_CCTTTCTTGCAC	Prog
BM4_CCTTTGATGTTT	T
BM4_CCTTTGCTCAAG	T
BM4_CCTTTGGAGTCA	GMP
BM4_CCTTTGTAAGCG	B
BM4_CCTTTTAACGCG	ProMono
BM4_CCTTTTGAAAAT	NK
BM4_CCTTTTTGACAN	lateEry
BM4_CCTTTTTTGACA	lateEry
BM4_CGAAAAGGATGA	Prog
BM4_CGAAAGAGAGGA	Prog
BM4_CGAAATATGCAA	ProMono
BM4_CGAAATCTATGA	CTL
BM4_CGAAATCTGAAG	GMP
BM4_CGAAATGAGTAC	Prog
BM4_CGAACAATAACG	GMP
BM4_CGAACACAGACT	CTL
BM4_CGAACGCTGAAN	GMP
BM4_CGAACGTCGAAT	CTL
BM4_CGAACGTCGCGN	Mono
BM4_CGAACTGGGTGC	Prog
BM4_CGAAGCCACGGN	cDC
BM4_CGAAGCCCAAGC	GMP
BM4_CGAAGCGCCCCG	ProMono
BM4_CGAAGCGCTAAN	B
BM4_CGAAGGCATATN	Prog
BM4_CGAAGGGCGCGA	GMP
BM4_CGAAGGGCTTCN	ProMono
BM4_CGAAGTATACAC	ProMono
BM4_CGAAGTCGCTCC	T
BM4_CGAAGTGCATGA	B
BM4_CGAAGTTCCACG	Mono
BM4_CGAAGTTGGAAC	GMP
BM4_CGAAGTTTTCCC	T
BM4_CGAATCCATCAG	T
BM4_CGAATGTTGCTG	Plasma
BM4_CGAATTCAGTAA	Plasma
BM4_CGACACCGTCTT	ProMono
BM4_CGACAGTGGCCG	cDC
BM4_CGACCATAACAT	Prog
BM4_CGACCCACTTTC	Prog
BM4_CGACCGGCTAAA	T
BM4_CGACCGTCAACT	T
BM4_CGACGCATCATG	earlyEry
BM4_CGACGCGGAACC	T
BM4_CGACTGGGCTAT	CTL
BM4_CGACTTTAGCAC	Mono
BM4_CGACTTTAGTCG	ProMono
BM4_CGACTTTCGGTG	earlyEry
BM4_CGAGAGACAAGA	GMP
BM4_CGAGATTATCTC	Prog
BM4_CGAGATTTGTCN	cDC
BM4_CGAGCACGGTGN	lateEry
BM4_CGAGCAGCTCTA	earlyEry
BM4_CGAGCATGCGCA	ProMono
BM4_CGAGCATGTAGT	earlyEry
BM4_CGAGCGCAATAN	NK
BM4_CGAGCGGAAAAN	GMP
BM4_CGAGCGGAATGT	ProMono
BM4_CGAGGCAAAAAA	ProB
BM4_CGAGGGCATCAC	T
BM4_CGAGGGGACGAA	cDC
BM4_CGAGGTTGGTTC	Prog
BM4_CGAGTAACCCCG	T
BM4_CGAGTACGTGTG	Prog
BM4_CGAGTCACTACA	T
BM4_CGAGTGTAATCN	earlyEry
BM4_CGAGTGTAATTC	earlyEry
BM4_CGAGTTAACTGA	B
BM4_CGAGTTCGATCN	GMP
BM4_CGATAACTCATG	T
BM4_CGATACGTGTGN	Prog
BM4_CGATAGCAACGA	earlyEry
BM4_CGATCTACGCGN	GMP
BM4_CGATGCGCTTCA	B
BM4_CGATGGGACTGN	CTL
BM4_CGATTACAGCGT	T
BM4_CGATTATTCACC	ProMono
BM4_CGATTCTATTTN	earlyEry
BM4_CGATTGGGCCGN	CTL
BM4_CGATTGTTAGCN	lateEry
BM4_CGATTGTTATGC	lateEry
BM4_CGATTTATGTGA	T
BM4_CGCAAAATCCCN	T
BM4_CGCAAACTAAAN	lateEry
BM4_CGCAAACTTAAA	lateEry
BM4_CGCAACAAGTCT	cDC
BM4_CGCAACTCTAAG	T
BM4_CGCAAGATGGGN	earlyEry
BM4_CGCAAGGTCTCN	lateEry
BM4_CGCAATGTCCCG	T
BM4_CGCACAAGTAGN	Prog
BM4_CGCACAGTTGGA	earlyEry
BM4_CGCACCATTTCC	earlyEry
BM4_CGCACCGGGCCT	cDC
BM4_CGCACTATTCCT	Mono
BM4_CGCAGAGGCGCC	ProB
BM4_CGCAGATAGACT	Prog
BM4_CGCAGGCATCGT	Mono
BM4_CGCAGGTTTGCN	Prog
BM4_CGCAGTAAGGCC	GMP
BM4_CGCATCGCAACA	Prog
BM4_CGCATCTAATGG	earlyEry
BM4_CGCATGCCCGAC	T
BM4_CGCATGGAGTAC	Mono
BM4_CGCATTAAGGCA	ProMono
BM4_CGCATTTGGGAN	earlyEry
BM4_CGCCAACGCCCA	Prog
BM4_CGCCACCTTATN	earlyEry
BM4_CGCCACCTTTAT	earlyEry
BM4_CGCCAGCAGATA	B
BM4_CGCCAGGCTAAT	GMP
BM4_CGCCAGTCTTAG	B
BM4_CGCCAGTTTCGT	lateEry
BM4_CGCCATCTCCAN	Prog
BM4_CGCCCCTACCTA	NK
BM4_CGCCGACAACTT	Prog
BM4_CGCCGGCGCTGC	cDC
BM4_CGCCGGCTCTTA	Prog
BM4_CGCCTACGGCAG	Mono
BM4_CGCCTATCTCCA	Prog
BM4_CGCCTCCGATTT	Mono
BM4_CGCCTGCTCGTC	ProMono
BM4_CGCCTTCAGCGA	T
BM4_CGCGAGCATTTT	GMP
BM4_CGCGATGGTCTT	ProMono
BM4_CGCGATTTGGGA	earlyEry
BM4_CGCGCCGTAGTG	cDC
BM4_CGCGCCGTCCAT	Mono
BM4_CGCGCGTAGGGT	ProMono
BM4_CGCGGACGATAA	Mono
BM4_CGCGGCGGGTGN	Mono
BM4_CGCGGTTTACGN	Prog
BM4_CGCGGTTTTGCG	Mono
BM4_CGCGTAAGACAG	earlyEry
BM4_CGCGTCCCTGTN	NK
BM4_CGCGTCTGTGCT	ProMono
BM4_CGCGTCTTCGAG	ProMono
BM4_CGCGTTTATATN	lateEry
BM4_CGCTAAATCTGN	Prog
BM4_CGCTAATAATAG	NK
BM4_CGCTCAGGACTA	ProMono
BM4_CGCTCGACAATC	ProMono
BM4_CGCTCGGGTTCC	cDC
BM4_CGCTCTGGCGAC	T
BM4_CGCTGAATCGCT	T
BM4_CGCTGAGAATCN	T
BM4_CGCTGCGCCACC	CTL
BM4_CGCTGGCGCAAT	CTL
BM4_CGCTGGTGTCGC	Prog
BM4_CGCTTCAGAATN	earlyEry
BM4_CGCTTCCTTGGN	GMP
BM4_CGCTTCGGAACN	Prog
BM4_CGCTTCTTTCCG	ProB
BM4_CGCTTGAGGTAG	Mono
BM4_CGCTTTAAGACN	B
BM4_CGCTTTTAGCGA	Prog
BM4_CGGAAATTGTAC	ProMono
BM4_CGGAACTGGCGC	GMP
BM4_CGGAAGTCTCGC	pDC
BM4_CGGAAGTGAGAA	Mono
BM4_CGGACACTAAAC	ProMono
BM4_CGGACTAGGTAN	T
BM4_CGGACTCAGCAG	Prog
BM4_CGGACTGCTGCT	GMP
BM4_CGGAGAGGCGCC	ProMono
BM4_CGGAGTCCGGCN	ProMono
BM4_CGGATAATTGAN	NK
BM4_CGGATACGCCCT	Mono
BM4_CGGATCACAAGN	Plasma
BM4_CGGATTATTTCG	T
BM4_CGGCAGGATAAG	NK
BM4_CGGCAGGGCATN	GMP
BM4_CGGCCAGCGTTN	T
BM4_CGGCCGCTGTAN	cDC
BM4_CGGCCGTGACTT	earlyEry
BM4_CGGCCGTGAGGT	NK
BM4_CGGCGCCAGACT	Prog
BM4_CGGCGTTGCCGN	lateEry
BM4_CGGCTCCCCGTG	B
BM4_CGGCTCCTCCAG	GMP
BM4_CGGCTCTGTATA	Plasma
BM4_CGGCTGCGTGTN	Plasma
BM4_CGGGAACAACTC	earlyEry
BM4_CGGGACATGTCG	Mono
BM4_CGGGAGAGGATA	T
BM4_CGGGAGCTTGAC	Prog
BM4_CGGGAGTCTAGC	earlyEry
BM4_CGGGATTTGCCA	B
BM4_CGGGCATAAGGC	NK
BM4_CGGGCCATCTTT	GMP
BM4_CGGGCCCATGTA	GMP
BM4_CGGGCCTCCATN	ProMono
BM4_CGGGCGAGCTCC	CTL
BM4_CGGGGACAGCGA	Mono
BM4_CGGGGAGAAGGA	Prog
BM4_CGGGGCCCGGTN	ProMono
BM4_CGGGGGTGTCTG	ProB
BM4_CGGGGTCAATCG	Mono
BM4_CGGGGTTTGGTA	GMP
BM4_CGGGTAGCCACN	Mono
BM4_CGGGTAGCTGCT	Mono
BM4_CGGGTATGGAGA	GMP
BM4_CGGGTCACACAT	pDC
BM4_CGGGTCTGTTGG	ProMono
BM4_CGGGTGTGGTTT	NK
BM4_CGGGTTACTATA	ProB
BM4_CGGGTTATTCAN	NK
BM4_CGGGTTCGGACN	Mono
BM4_CGGGTTGGAGAT	B
BM4_CGGGTTGGCTGT	NK
BM4_CGGTAATAGTTT	NK
BM4_CGGTATCACTTN	ProMono
BM4_CGGTCACGCCGA	T
BM4_CGGTCCCGGTGT	cDC
BM4_CGGTCGAGTTTC	CTL
BM4_CGGTCTCATCGN	Prog
BM4_CGGTGATGTCGN	cDC
BM4_CGGTGCAGGCTA	T
BM4_CGGTGCATTAGN	GMP
BM4_CGGTGGACGCGN	NK
BM4_CGGTGGCTATAN	B
BM4_CGGTGGGGTTCT	GMP
BM4_CGGTGTAGTGGA	B
BM4_CGGTTAGGGAGA	Prog
BM4_CGGTTAGTATAG	ProMono
BM4_CGGTTATAAAAN	Mono
BM4_CGGTTCCAATGG	ProMono
BM4_CGGTTGGTTCGN	ProMono
BM4_CGGTTTCAGCGT	ProMono
BM4_CGTAAGCAGATT	CTL
BM4_CGTAATCTATAC	ProMono
BM4_CGTAATCTCCGN	Prog
BM4_CGTACATCGGTG	Mono
BM4_CGTACTGCCAGA	GMP
BM4_CGTAGATCATGN	CTL
BM4_CGTAGTTCTCAN	cDC
BM4_CGTAGTTGATAG	Prog
BM4_CGTATTGCATTA	earlyEry
BM4_CGTCAAAGGCTG	GMP
BM4_CGTCAAGGAAGG	Prog
BM4_CGTCACCGTGGA	pDC
BM4_CGTCAGCTGAAG	NK
BM4_CGTCAGCTTGCT	lateEry
BM4_CGTCAGGTAGCT	Plasma
BM4_CGTCCAACTTAN	ProMono
BM4_CGTCCACATGCT	earlyEry
BM4_CGTCCGACAGAC	earlyEry
BM4_CGTCCGGATGCG	T
BM4_CGTCGACACTGC	GMP
BM4_CGTCGAGATTTN	NK
BM4_CGTCGATATATN	T
BM4_CGTCGCAGGACN	CTL
BM4_CGTCGCCACCGC	earlyEry
BM4_CGTCGCGTCAGC	earlyEry
BM4_CGTCGGTGTCCG	Prog
BM4_CGTCTAGCGGAC	Mono
BM4_CGTCTCAATAGC	GMP
BM4_CGTCTCCGGATA	T
BM4_CGTCTGGTGTGG	ProMono
BM4_CGTCTTGAGCCN	ProMono
BM4_CGTGAAATGTAG	earlyEry
BM4_CGTGAACACAAG	Mono
BM4_CGTGACACGCCN	CTL
BM4_CGTGCGAGATTG	Prog
BM4_CGTGCGAGGCCN	ProMono
BM4_CGTGCTCTAGCG	T
BM4_CGTGGCTAGGCT	ProB
BM4_CGTGGGACTTGN	NK
BM4_CGTGGGAGCTGT	ProMono
BM4_CGTGGTCATTTT	ProMono
BM4_CGTGGTCCTCCN	ProB
BM4_CGTGGTGTCCTA	CTL
BM4_CGTGGTTAAGTA	Prog
BM4_CGTGGTTCTAGN	T
BM4_CGTGTCTCGCGN	earlyEry
BM4_CGTGTGCCCGTN	Prog
BM4_CGTGTGCTCCGN	Plasma
BM4_CGTGTGTATGCC	T
BM4_CGTGTTAAGGAC	ProMono
BM4_CGTGTTCCGTTG	Prog
BM4_CGTGTTGTAGCC	Mono
BM4_CGTTAAACAAGA	earlyEry
BM4_CGTTAAATGTTC	pDC
BM4_CGTTAATCGTCG	T
BM4_CGTTAATTGCAN	cDC
BM4_CGTTACTTAGCC	cDC
BM4_CGTTAGCTTACN	GMP
BM4_CGTTAGCTTTAC	GMP
BM4_CGTTATCATGAN	earlyEry
BM4_CGTTCAGCGACN	pDC
BM4_CGTTCATGTCGN	GMP
BM4_CGTTCCCAGGTN	earlyEry
BM4_CGTTCCGGAGAG	ProMono
BM4_CGTTCGATAATN	Prog
BM4_CGTTCGGGCCCA	Mono
BM4_CGTTCGTCAGTA	Mono
BM4_CGTTGCCGCGTA	earlyEry
BM4_CGTTGGAGGATG	ProMono
BM4_CGTTGGCCATAT	T
BM4_CGTTGGTGGAGC	earlyEry
BM4_CGTTTAAGAGAA	ProMono
BM4_CGTTTAGCAGTC	cDC
BM4_CGTTTATCCCCA	T
BM4_CGTTTCACTGCT	T
BM4_CGTTTCCAGTGG	GMP
BM4_CGTTTCGTTGAT	Prog
BM4_CGTTTCTACCAN	earlyEry
BM4_CGTTTGACCGTN	CTL
BM4_CGTTTTAAGCAC	GMP
BM4_CGTTTTCGTAAG	Prog
BM4_CGTTTTGTGTGG	Mono
BM4_CGTTTTTGCTAG	CTL
BM4_CTAAAACAAGCA	Mono
BM4_CTAAAACGATTC	Mono
BM4_CTAAACCGTATA	lateEry
BM4_CTAAACGACGAA	GMP
BM4_CTAACAGCCAGN	T
BM4_CTAACAGGCGTG	GMP
BM4_CTAACATCGGTT	T
BM4_CTAACCGGTGAA	T
BM4_CTAACGCCGAGC	ProB
BM4_CTAACGTTTAGC	ProB
BM4_CTAAGAACGGGA	B
BM4_CTAAGACAGCGN	T
BM4_CTAAGAGTTCCT	lateEry
BM4_CTAAGCCACTTG	T
BM4_CTAAGCCTCGGN	T
BM4_CTAAGGACGAAN	B
BM4_CTAAGTTACTGT	GMP
BM4_CTAATAGGAGAN	cDC
BM4_CTAATAGGAGTA	cDC
BM4_CTAATGAAGGAC	GMP
BM4_CTAATGATGCTC	T
BM4_CTAATGGTGTAC	T
BM4_CTACACGCAATA	cDC
BM4_CTACACGTCTAT	T
BM4_CTACAGTAAAGG	Mono
BM4_CTACAGTCGCAN	ProMono
BM4_CTACAGTTCGCA	ProMono
BM4_CTACCATCATGG	ProMono
BM4_CTACCATTGTGN	ProMono
BM4_CTACCCAACCTA	Prog
BM4_CTACCCAATTCC	Prog
BM4_CTACCGACTGTC	ProB
BM4_CTACCTTTCAGG	cDC
BM4_CTACGCAGCCCG	T
BM4_CTACGCCTTCGN	T
BM4_CTACGTCAGGTT	T
BM4_CTACTAGGGTCA	ProMono
BM4_CTACTCTTACAA	ProMono
BM4_CTAGAACTTGAC	GMP
BM4_CTAGAGCACGCG	ProMono
BM4_CTAGCCGGAGTN	NK
BM4_CTAGGCAGAGTN	earlyEry
BM4_CTAGGCCAGTTT	ProB
BM4_CTAGGCCTGCAC	cDC
BM4_CTAGGGTCCACA	Mono
BM4_CTAGGTACATTA	GMP
BM4_CTAGTCACGAGA	Prog
BM4_CTAGTCACGTGT	T
BM4_CTAGTTCCACGA	pDC
BM4_CTATAATCAGAC	T
BM4_CTATCAATAACN	ProMono
BM4_CTATCAGTAATN	CTL
BM4_CTATCCATCCGA	earlyEry
BM4_CTATCCTCGTAA	Prog
BM4_CTATCCTGCGCN	ProMono
BM4_CTATGAACTAAC	Prog
BM4_CTATGATTCCGT	CTL
BM4_CTATGCTAGTTN	GMP
BM4_CTATGTGCTATA	ProMono
BM4_CTATGTGGATCA	Mono
BM4_CTATTGGTAAGG	earlyEry
BM4_CTATTGTGACTG	GMP
BM4_CTCAAGCCTGGN	T
BM4_CTCACAGTACCG	GMP
BM4_CTCACAGTGGAT	Mono
BM4_CTCACCATGAAT	T
BM4_CTCAGAATGAGN	Mono
BM4_CTCAGCAAGTAN	Prog
BM4_CTCAGCAAGTTA	Prog
BM4_CTCAGCACGTGC	earlyEry
BM4_CTCAGTCGGTTA	Prog
BM4_CTCAGTGCTAAA	Mono
BM4_CTCATAGCCTTN	cDC
BM4_CTCATCGGGGGG	earlyEry
BM4_CTCATGTCTAAT	cDC
BM4_CTCATTTTTACA	CTL
BM4_CTCCAGAGATGG	CTL
BM4_CTCCAGCTGACN	cDC
BM4_CTCCATAATGAA	T
BM4_CTCCATATAGGG	lateEry
BM4_CTCCCAGTCGTA	earlyEry
BM4_CTCCGCGTCTTA	ProMono
BM4_CTCCGTGGTAAN	T
BM4_CTCCGTTTTTAN	CTL
BM4_CTCCTAATTCGN	GMP
BM4_CTCCTAGCTACG	GMP
BM4_CTCCTCCTATAC	NK
BM4_CTCCTGTCGTCC	GMP
BM4_CTCCTTAAGTTN	Mono
BM4_CTCGAGATGCTG	cDC
BM4_CTCGGCAATTAG	CTL
BM4_CTCGGCGTCACN	Prog
BM4_CTCGGCTCTGAG	Prog
BM4_CTCGGGTGCCGT	ProB
BM4_CTCGTAAGCTTC	cDC
BM4_CTCGTAATTCAG	T
BM4_CTCGTATGGCGC	T
BM4_CTCGTCGATTTT	CTL
BM4_CTCGTCTCTGAA	ProMono
BM4_CTCGTTGAGCTT	earlyEry
BM4_CTCGTTGCCGTG	earlyEry
BM4_CTCTAGCTTTTT	cDC
BM4_CTCTATTAAGTN	Plasma
BM4_CTCTCCTACATN	B
BM4_CTCTGACGGTTT	T
BM4_CTCTGATTTAAN	cDC
BM4_CTCTGCACAGGC	GMP
BM4_CTCTGGTCCTGG	lateEry
BM4_CTCTTCCATTTN	T
BM4_CTCTTCGCTGCT	ProMono
BM4_CTCTTGATGATT	GMP
BM4_CTCTTTAACGGG	GMP
BM4_CTCTTTCGTTCN	T
BM4_CTGAAAATGTTT	ProMono
BM4_CTGAACAAGGAT	earlyEry
BM4_CTGAACGCGACA	Mono
BM4_CTGAAGGAGATA	NK
BM4_CTGAAGGCGATC	T
BM4_CTGAATCACATA	CTL
BM4_CTGACCGCGTCC	Prog
BM4_CTGACGAAGCGA	GMP
BM4_CTGACGCAAGTG	T
BM4_CTGACGCTATGC	earlyEry
BM4_CTGAGTAACGGN	ProMono
BM4_CTGCAAGGAGAA	cDC
BM4_CTGCAATAAGAG	ProMono
BM4_CTGCCCGGGTTN	Prog
BM4_CTGCCGATATCC	ProMono
BM4_CTGCGCTACCTC	GMP
BM4_CTGCGCTTGACT	ProMono
BM4_CTGCTATCCCAN	Mono
BM4_CTGCTCCCTGAN	ProMono
BM4_CTGCTCCGGGTT	HSC
BM4_CTGGAAACATAN	GMP
BM4_CTGGAAGGACAN	ProMono
BM4_CTGGAGGTAACA	Mono
BM4_CTGGCAAGCGGN	lateEry
BM4_CTGGCCCAGTCC	T
BM4_CTGGGAGTCACN	lateEry
BM4_CTGGGAGTCATC	lateEry
BM4_CTGGGCAGGCCT	cDC
BM4_CTGGGCATAAGN	Prog
BM4_CTGGGCCAACTA	earlyEry
BM4_CTGGGCGTTGCN	pDC
BM4_CTGGGGGCCTGT	earlyEry
BM4_CTGGTACCCGCC	Prog
BM4_CTGGTAGTCATT	ProMono
BM4_CTGGTCCGCCAA	B
BM4_CTGGTTAGAGAN	T
BM4_CTGTAATGCGGT	Prog
BM4_CTGTATAGTTTN	Mono
BM4_CTGTCATTGGAG	T
BM4_CTGTCGGTCGCN	ProMono
BM4_CTGTCTCACTCA	CTL
BM4_CTGTGTTGCGGN	Prog
BM4_CTGTTATCCAAT	Mono
BM4_CTGTTATTGGGN	ProMono
BM4_CTGTTCGGCGTA	T
BM4_CTGTTGCTGTAA	Prog
BM4_CTGTTTAGGTTA	Prog
BM4_CTTAACGGTCTC	Mono
BM4_CTTAATCACCGG	T
BM4_CTTAATTGATGC	Mono
BM4_CTTACAATGGTA	Mono
BM4_CTTACCATTTCN	lateEry
BM4_CTTAGCGTCAAN	T
BM4_CTTATCCGTGCN	T
BM4_CTTATGACAACN	T
BM4_CTTATTATAACN	T
BM4_CTTCAGAAGCTT	Mono
BM4_CTTCAGCAAGAA	T
BM4_CTTCCATACATG	earlyEry
BM4_CTTCCATTGGCG	T
BM4_CTTCCCATTGCT	ProMono
BM4_CTTCCCTTTGCN	CTL
BM4_CTTCCGTAGCAG	Mono
BM4_CTTCCGTAGTAN	ProMono
BM4_CTTCCTTGCGTA	lateEry
BM4_CTTCGATTGGTC	CTL
BM4_CTTCGGAGGGGT	ProB
BM4_CTTCTCATATTA	B
BM4_CTTCTCGATAGT	GMP
BM4_CTTCTGTTCGCC	T
BM4_CTTGAAGTAGCA	Mono
BM4_CTTGATGATGTN	ProMono
BM4_CTTGCAGCCAGG	Prog
BM4_CTTGCGCGCGTN	ProMono
BM4_CTTGCGTCCCGN	B
BM4_CTTGCTCCTAGT	Mono
BM4_CTTGCTGGCAAC	Prog
BM4_CTTGGAAATAAN	lateEry
BM4_CTTGGATTTCCG	ProMono
BM4_CTTGGCAAATTC	GMP
BM4_CTTGGCGTCTAT	T
BM4_CTTGTACGATAN	ProMono
BM4_CTTGTAGACATN	ProMono
BM4_CTTGTCGCGATN	CTL
BM4_CTTGTTACGATA	ProMono
BM4_CTTGTTTCGACA	T
BM4_CTTTAGCGTCGN	earlyEry
BM4_CTTTATTAATCN	NK
BM4_CTTTCAACAAAN	GMP
BM4_CTTTCAATCAAN	Mono
BM4_CTTTCACCGGAC	ProMono
BM4_CTTTCAGCTTTC	ProB
BM4_CTTTCCAGTAGG	ProMono
BM4_CTTTCGATGTTA	ProB
BM4_CTTTGCGCCTGT	GMP
BM4_CTTTGCTTCGGG	Mono
BM4_CTTTGTCTACGN	Prog
BM4_CTTTTCAAAGTA	T
BM4_CTTTTCAGGACN	earlyEry
BM4_CTTTTGACATAC	CTL
BM4_CTTTTTCCCGGG	CTL
BM4_GAAAACGGGTTT	T
BM4_GAAAACGTCAGC	GMP
BM4_GAAAAGAGGTTT	CTL
BM4_GAAAAGTCAGAT	CTL
BM4_GAAAAGTTCACC	cDC
BM4_GAAACAGGATAT	CTL
BM4_GAAACAGTTGCA	CTL
BM4_GAAACGCTGCGA	T
BM4_GAAACGGGGTTT	Prog
BM4_GAAACGTTGTGA	ProMono
BM4_GAAAGCTTGTTA	Plasma
BM4_GAAAGGCCATTG	Prog
BM4_GAAAGTAACATA	NK
BM4_GAAAGTCTTAGG	pDC
BM4_GAAAGTGTGCAG	cDC
BM4_GAAAGTTTGCGA	CTL
BM4_GAAATAAGACCN	Mono
BM4_GAAATGAAATCA	B
BM4_GAAATGTGCAGN	cDC
BM4_GAAATTACAGAT	Mono
BM4_GAAATTACGTAG	Mono
BM4_GAACACCGGCCN	ProB
BM4_GAACAGTCGTTN	NK
BM4_GAACATTAGATT	T
BM4_GAACATTTTCAN	earlyEry
BM4_GAACCGAGTTTG	lateEry
BM4_GAACCGTCGCAC	B
BM4_GAACGTACTATG	Mono
BM4_GAACGTTTAGCA	Mono
BM4_GAACTATAGGGN	lateEry
BM4_GAAGAGTATATT	T
BM4_GAAGCCCTGTTT	ProMono
BM4_GAAGCTTCACAG	Prog
BM4_GAAGGAAACATT	Mono
BM4_GAAGGAATTAAA	lateEry
BM4_GAAGGAGAAGGG	CTL
BM4_GAAGGCAGCCCA	T
BM4_GAAGTCCAAAGT	earlyEry
BM4_GAAGTCCCGAAC	GMP
BM4_GAAGTCGTTGTC	GMP
BM4_GAAGTTCTTGAG	pDC
BM4_GAATCAAAGTTT	cDC
BM4_GAATCAACCCAT	Mono
BM4_GAATCCCGAACN	GMP
BM4_GAATCGGAATGG	T
BM4_GAATCGTTAGGN	HSC
BM4_GAATTAGTCTCA	Mono
BM4_GAATTCCTCAGC	ProMono
BM4_GAATTCGAATCG	Mono
BM4_GAATTGGAACAA	B
BM4_GAATTTATTCCT	T
BM4_GAATTTCCGCTG	GMP
BM4_GAATTTTGTGAA	B
BM4_GACAACCCTTGN	ProMono
BM4_GACAACTGGTCG	Prog
BM4_GACAAGCTTGTT	GMP
BM4_GACAATGTATCC	T
BM4_GACACATGGACN	earlyEry
BM4_GACACATTGGAC	earlyEry
BM4_GACACCTTCAGG	cDC
BM4_GACACGGTCTTC	ProMono
BM4_GACAGACAGTGT	ProMono
BM4_GACAGCGCTATN	Mono
BM4_GACAGTACGGGT	ProMono
BM4_GACATCATTACA	GMP
BM4_GACATGATCAAG	lateEry
BM4_GACATGCGATGT	ProB
BM4_GACATTTGGCTN	GMP
BM4_GACCACTTCCAN	CTL
BM4_GACCAGAAGAGA	ProMono
BM4_GACCAGATTGTN	NK
BM4_GACCAGGACTGA	T
BM4_GACCATCGAGCC	ProMono
BM4_GACCCAGACTAT	cDC
BM4_GACCCTGACATT	Mono
BM4_GACCCTTCACGG	lateEry
BM4_GACCCTTTGTTG	NK
BM4_GACCGACCATGT	lateEry
BM4_GACCGCCGCGGN	ProMono
BM4_GACGAGATGCTT	T
BM4_GACGAGGCGGTA	GMP
BM4_GACGCCGTAAGG	pDC
BM4_GACGGCAGGTCA	ProB
BM4_GACGGGTTCGTG	ProMono
BM4_GACGGTCTTTTT	B
BM4_GACGGTGCGTCC	cDC
BM4_GACGTACCACTG	ProMono
BM4_GACGTAGATGCT	earlyEry
BM4_GACGTAGCTAGT	ProMono
BM4_GACGTGCTAGAN	ProMono
BM4_GACGTGGGAACN	T
BM4_GACGTTGGCTTT	earlyEry
BM4_GACTCGATCAAN	Prog
BM4_GACTGACAGAGG	B
BM4_GACTTAAGAGTN	T
BM4_GACTTCTTCCGT	earlyEry
BM4_GACTTTCGCAGA	GMP
BM4_GAGAATCAGTTT	ProMono
BM4_GAGACGACGTAG	earlyEry
BM4_GAGACGGCGCTC	cDC
BM4_GAGAGAAAACGG	T
BM4_GAGAGCTCAGAT	T
BM4_GAGAGTGAAGCN	earlyEry
BM4_GAGAGTGTGTTN	cDC
BM4_GAGATAACTACN	Prog
BM4_GAGATCTGCCAT	lateEry
BM4_GAGATGCCTAAT	GMP
BM4_GAGCAAGCAATG	ProMono
BM4_GAGCACCCGAGT	Mono
BM4_GAGCAGACTTTT	GMP
BM4_GAGCATTGTTAN	ProMono
BM4_GAGCCGCATGTT	earlyEry
BM4_GAGCCGTACTTA	ProMono
BM4_GAGCGACCCAAT	GMP
BM4_GAGCGACTCTCN	Prog
BM4_GAGCGCAAGGTN	T
BM4_GAGCTACCTGTG	Plasma
BM4_GAGCTGCGTGAT	ProMono
BM4_GAGCTGGTCTCA	GMP
BM4_GAGCTTAACCAN	GMP
BM4_GAGCTTTTTCCN	earlyEry
BM4_GAGGACGAGACT	ProMono
BM4_GAGGATCTGACG	ProMono
BM4_GAGGCATAGTGA	lateEry
BM4_GAGGGCGCGGGN	ProMono
BM4_GAGGGCTAGGAC	earlyEry
BM4_GAGGGTGCGGAC	lateEry
BM4_GAGGTAGCCTGN	ProB
BM4_GAGGTATGTGAN	Prog
BM4_GAGGTCCAGGGT	ProB
BM4_GAGGTCCGCGCC	NK
BM4_GAGGTCGCGACA	ProB
BM4_GAGGTCTTCACA	Mono
BM4_GAGGTGGTACAA	cDC
BM4_GAGGTGTCTCTG	ProMono
BM4_GAGGTTCTACGA	GMP
BM4_GAGGTTCTTGAC	GMP
BM4_GAGTAACAACTG	Mono
BM4_GAGTACCCTATG	Prog
BM4_GAGTAGGCGGTA	HSC
BM4_GAGTATATTTAN	Prog
BM4_GAGTATTCTTGA	T
BM4_GAGTCTTTGAGN	T
BM4_GAGTGAACGGTC	Mono
BM4_GAGTGCACTCAC	Prog
BM4_GAGTGCGCGTTA	lateEry
BM4_GAGTGCTGCCCC	GMP
BM4_GAGTGGCTCGGA	cDC
BM4_GAGTGGTATTTC	cDC
BM4_GAGTGTCCCGCN	ProMono
BM4_GAGTGTTGCAGN	earlyEry
BM4_GAGTTATCCCCT	ProB
BM4_GAGTTATGGCCC	T
BM4_GAGTTTAAGTAN	Prog
BM4_GAGTTTATCAGC	B
BM4_GAGTTTATGGTT	ProMono
BM4_GATAAATCGGAN	cDC
BM4_GATAAATGCGCN	ProMono
BM4_GATAACAAGCTT	Prog
BM4_GATAACCTCCTT	Prog
BM4_GATACAGGGATN	cDC
BM4_GATACCCTGTCG	ProMono
BM4_GATAGAGGACCG	Mono
BM4_GATAGGATATTC	CTL
BM4_GATAGGGCGTTA	T
BM4_GATAGGTTTATN	Mono
BM4_GATATATGTGCC	earlyEry
BM4_GATATCTGCATA	cDC
BM4_GATATTACTCCT	Mono
BM4_GATCACCGGAGT	cDC
BM4_GATCACTCGTGN	Plasma
BM4_GATCCACGCGGN	earlyEry
BM4_GATCCCCTATTN	T
BM4_GATCCGGTATGN	lateEry
BM4_GATCCTCCACGN	Prog
BM4_GATCGCGTCTTC	GMP
BM4_GATCGCTATATG	Prog
BM4_GATCGGAGGAAA	NK
BM4_GATCGGTTAGAN	GMP
BM4_GATCGTTGTACG	Mono
BM4_GATCTACATAGN	Mono
BM4_GATCTCAAACTT	GMP
BM4_GATCTGCTCAAN	earlyEry
BM4_GATCTTACATAG	ProMono
BM4_GATCTTCTTGAN	T
BM4_GATGAACAGCCG	lateEry
BM4_GATGAAGAGCCC	ProB
BM4_GATGACCACACG	Mono
BM4_GATGAGGAGTAC	T
BM4_GATGAGGATATN	CTL
BM4_GATGAGTCCGCC	Prog
BM4_GATGAGTGGTAT	ProMono
BM4_GATGATCACTGA	NK
BM4_GATGCAGGAAGG	GMP
BM4_GATGCGTAGCTC	cDC
BM4_GATGCTTTTTCC	earlyEry
BM4_GATGGACGCACA	ProB
BM4_GATGGACGCTGA	earlyEry
BM4_GATGGAGCATAC	CTL
BM4_GATGGAGCGTAA	GMP
BM4_GATGGCAGAACC	cDC
BM4_GATGGCTTGATA	Mono
BM4_GATGGCTTTCCC	GMP
BM4_GATGGGGCGCGA	HSC
BM4_GATGTCCCTATN	CTL
BM4_GATGTCGTTCTA	NK
BM4_GATGTGAGTCAN	ProMono
BM4_GATGTGTGTGAG	cDC
BM4_GATGTTGCAACN	Prog
BM4_GATTAAACGTAC	T
BM4_GATTAGCCTGAT	Mono
BM4_GATTATGAAATA	Prog
BM4_GATTATTCGTCC	T
BM4_GATTCACTGCGN	GMP
BM4_GATTCACTGCTG	GMP
BM4_GATTCGTCCACN	T
BM4_GATTCTAGAGCT	B
BM4_GATTCTGTGTCA	B
BM4_GATTGCCCCTAG	Mono
BM4_GATTGGACTAAA	Prog
BM4_GATTGTTAAAGN	earlyEry
BM4_GATTTCACGCCG	Prog
BM4_GATTTCCGTGCG	ProB
BM4_GATTTGAAAATG	ProB
BM4_GATTTGATTCAT	T
BM4_GATTTGGCAAAN	ProB
BM4_GATTTGGTGTGA	earlyEry
BM4_GATTTTGCACTN	Mono
BM4_GCAAAAAGTGCA	earlyEry
BM4_GCAAAGCGAGGT	cDC
BM4_GCAAAGTTTCTN	NK
BM4_GCAAATGTCCAN	ProMono
BM4_GCAAATTCGGTN	Mono
BM4_GCAACAAACGGT	T
BM4_GCAACAAATTGC	B
BM4_GCAACATCGATT	CTL
BM4_GCAACGCAATGA	lateEry
BM4_GCAACGGATTTA	Mono
BM4_GCAACGTCACGT	T
BM4_GCAACTAGCGGG	Prog
BM4_GCAACTCCTGCT	ProMono
BM4_GCAAGCAAGGTT	Prog
BM4_GCAAGGCCTTCT	CTL
BM4_GCAATAAACCTC	GMP
BM4_GCAATCTCACAG	CTL
BM4_GCAATTGAAGGA	earlyEry
BM4_GCACAGACGAAG	cDC
BM4_GCACATAGTGCC	ProMono
BM4_GCACATTTGGAC	Mono
BM4_GCACCCCATTAT	lateEry
BM4_GCACCCGGCCAN	earlyEry
BM4_GCACGCTCCCTA	NK
BM4_GCACGGAACGCN	NK
BM4_GCACGGGTATAA	Mono
BM4_GCACTATTGGAT	ProMono
BM4_GCACTCTCTAGA	GMP
BM4_GCACTTACGAGN	GMP
BM4_GCACTTGCCCAN	NK
BM4_GCAGAAGAGCTG	ProMono
BM4_GCAGAAGCGACT	Prog
BM4_GCAGAAGCTTTG	pDC
BM4_GCAGACGTGCCN	GMP
BM4_GCAGATACCGAG	CTL
BM4_GCAGATATAGAG	lateEry
BM4_GCAGATCCGGTT	earlyEry
BM4_GCAGATTGGGCN	lateEry
BM4_GCAGCGCGGCTN	earlyEry
BM4_GCAGCGCGGGCT	earlyEry
BM4_GCAGCGGTGGAG	ProMono
BM4_GCAGGGTGTAAT	Prog
BM4_GCAGTAACCGAN	earlyEry
BM4_GCAGTACGGCAN	earlyEry
BM4_GCAGTGAGATCT	Prog
BM4_GCAGTGTAGGTG	T
BM4_GCAGTTGTGGGT	ProMono
BM4_GCATATTTCACA	T
BM4_GCATCACAGGAA	ProB
BM4_GCATCACGACCC	ProMono
BM4_GCATCATTCCAA	T
BM4_GCATCGCCGCTN	ProMono
BM4_GCATCGCTCGCT	ProMono
BM4_GCATCGTCGCCA	NK
BM4_GCATCTCAATCA	T
BM4_GCATCTCCACGG	T
BM4_GCATCTTCTCTN	ProMono
BM4_GCATGAAAAGGN	earlyEry
BM4_GCATGAAGTTCC	pDC
BM4_GCATGAGGAGTA	ProMono
BM4_GCATGCTCCAAC	T
BM4_GCATTCCACGAG	Prog
BM4_GCATTCTAATCG	cDC
BM4_GCATTCTTCTCT	ProMono
BM4_GCATTGTAAAGT	ProMono
BM4_GCATTTGTAGTC	ProMono
BM4_GCCAAAGATCGC	Mono
BM4_GCCAACGGTAAC	T
BM4_GCCAAGAGCTGN	T
BM4_GCCAAGCCAGTN	ProMono
BM4_GCCAAGCGATGT	earlyEry
BM4_GCCAAGGAGCAG	lateEry
BM4_GCCAATACTACA	T
BM4_GCCACATAAGGT	B
BM4_GCCACGCCGATG	Mono
BM4_GCCACGGTAGGN	ProMono
BM4_GCCAGCCCGTGC	Prog
BM4_GCCAGCGATGTN	earlyEry
BM4_GCCATTAGGGAA	NK
BM4_GCCATTTGCCGN	Prog
BM4_GCCATTTGTGAC	ProMono
BM4_GCCCAAATCGCT	T
BM4_GCCCACCTAAGG	ProB
BM4_GCCCAGCCTCAT	GMP
BM4_GCCCAGGTGCGN	earlyEry
BM4_GCCCCAGAATAA	earlyEry
BM4_GCCCCCGCAACT	T
BM4_GCCCCGCTGAGT	earlyEry
BM4_GCCCCTAATGTA	cDC
BM4_GCCCGACATTCG	T
BM4_GCCCGCGCGAGA	ProB
BM4_GCCCGGCTAAAN	ProMono
BM4_GCCCTAGAATAN	Mono
BM4_GCCCTGTCACTG	T
BM4_GCCGAAACAAGA	Mono
BM4_GCCGAGAAGCGA	ProMono
BM4_GCCGAGCTCGAN	ProMono
BM4_GCCGCGCATGAT	Prog
BM4_GCCGCTCAGTCC	pDC
BM4_GCCGCTTTTTAC	Prog
BM4_GCCGGACCTCGT	Mono
BM4_GCCGGACGGGAN	T
BM4_GCCGGCCGTTTT	T
BM4_GCCGGGTGCCAA	earlyEry
BM4_GCCGGGTTAGAN	GMP
BM4_GCCGGTGAACCN	T
BM4_GCCGGTTTCATA	GMP
BM4_GCCGTACTAGTC	Prog
BM4_GCCGTAGCATTN	T
BM4_GCCGTCTCGGAC	cDC
BM4_GCCGTTTTCTAT	T
BM4_GCCTATGGAAAA	Prog
BM4_GCCTATTAAAGA	ProMono
BM4_GCCTCACAAGAN	CTL
BM4_GCCTCCGTGTCT	Prog
BM4_GCCTCTCGTTCT	CTL
BM4_GCCTGCGCTCTA	T
BM4_GCCTTCTGGTCG	Mono
BM4_GCCTTGCAGTGG	T
BM4_GCCTTTTGGTGN	ProMono
BM4_GCGAAACCGGTT	lateEry
BM4_GCGAAATGTCCA	ProMono
BM4_GCGAATATCTTC	earlyEry
BM4_GCGACATGTTGG	earlyEry
BM4_GCGAGATTGTAA	cDC
BM4_GCGAGCCCGGAC	cDC
BM4_GCGAGTTAGGAA	CTL
BM4_GCGATAGCGTAA	Prog
BM4_GCGATCCGCTCN	T
BM4_GCGATCGGGAGA	ProMono
BM4_GCGATGAATAAA	earlyEry
BM4_GCGATGGCAGAA	ProMono
BM4_GCGATTTATTTN	Mono
BM4_GCGCACTAATAT	pDC
BM4_GCGCAGAGGCTC	GMP
BM4_GCGCCAATAACN	T
BM4_GCGCCACGGGTT	GMP
BM4_GCGCCGCTATTT	Prog
BM4_GCGCCGGCCCGG	ProMono
BM4_GCGCCTAGTTAG	Prog
BM4_GCGCCTTTGTTN	T
BM4_GCGCGCAGGAGN	lateEry
BM4_GCGCGGAGTGCN	Prog
BM4_GCGCGTCAGTCC	earlyEry
BM4_GCGCTAGAATCG	pDC
BM4_GCGCTTCTACAA	NK
BM4_GCGCTTGCCATT	cDC
BM4_GCGCTTTCTACT	CTL
BM4_GCGGCAAACTAT	GMP
BM4_GCGGCATTCGCT	lateEry
BM4_GCGGCCTTATAG	ProMono
BM4_GCGGCGGTACCT	Mono
BM4_GCGGCTAATTCC	ProMono
BM4_GCGGGCACCGCC	cDC
BM4_GCGGGGAGGCAN	lateEry
BM4_GCGGTACATAGT	GMP
BM4_GCGGTCAGACAA	Mono
BM4_GCGGTGACTTTC	cDC
BM4_GCGGTTCCTATG	ProMono
BM4_GCGGTTTGGGGC	Prog
BM4_GCGGTTTTTCTA	T
BM4_GCGTAATGATAA	lateEry
BM4_GCGTACTTGTTA	Mono
BM4_GCGTCTTCTTAT	Prog
BM4_GCGTGATCGCTN	Plasma
BM4_GCGTGCTGGCTN	Prog
BM4_GCGTGGTAACCA	Prog
BM4_GCGTGTTAGCTG	Prog
BM4_GCGTTAAGTCCC	GMP
BM4_GCGTTACGCTGG	Mono
BM4_GCGTTCTTTCGN	Prog
BM4_GCGTTTTGTTTG	ProMono
BM4_GCTAAACATGCT	T
BM4_GCTAAGGCCCGG	Mono
BM4_GCTAATCGTCGN	T
BM4_GCTAATTTGGGA	cDC
BM4_GCTACATACCGG	B
BM4_GCTACATGAAGC	earlyEry
BM4_GCTACTCGAAGN	ProMono
BM4_GCTACTGCTGAN	Prog
BM4_GCTAGAACGTCG	B
BM4_GCTAGCCTGTTG	earlyEry
BM4_GCTAGGCCGTTA	Mono
BM4_GCTATCCGGGCT	ProMono
BM4_GCTATTATTCCC	Mono
BM4_GCTATTCGTTTT	Prog
BM4_GCTCACGACAGG	Mono
BM4_GCTCCATCTCCA	T
BM4_GCTCCGCCATTG	Prog
BM4_GCTCCGGTCAGN	ProMono
BM4_GCTCCTTCGCAG	NK
BM4_GCTCGAGGAATC	Mono
BM4_GCTCGATTTACT	Mono
BM4_GCTCGCACATCC	T
BM4_GCTCGGACCACT	CTL
BM4_GCTCGTCAACGA	earlyEry
BM4_GCTCGTTACATT	earlyEry
BM4_GCTCTGCACAGT	GMP
BM4_GCTGAGCAACGT	lateEry
BM4_GCTGATTTACTN	Mono
BM4_GCTGCGGAGTCT	ProMono
BM4_GCTGCTGTCCTT	Prog
BM4_GCTGGAAGAGCA	Prog
BM4_GCTGGAATTCTC	GMP
BM4_GCTGGTTCTGCT	Mono
BM4_GCTGTAAATATT	B
BM4_GCTGTATCAATN	T
BM4_GCTGTCACGATG	lateEry
BM4_GCTGTGCTCAAN	Mono
BM4_GCTGTGGCTGTN	T
BM4_GCTGTGGTCCAN	ProB
BM4_GCTGTTCCCGTT	ProMono
BM4_GCTGTTTGCGTT	Prog
BM4_GCTTACTACTTN	T
BM4_GCTTAGCGGTTA	T
BM4_GCTTATCGCAGC	ProMono
BM4_GCTTATGCGCGG	Prog
BM4_GCTTCAGATGAA	ProMono
BM4_GCTTCATTATTG	CTL
BM4_GCTTCGGCCTGG	ProMono
BM4_GCTTGAACGCAT	ProB
BM4_GCTTGACCTGAT	NK
BM4_GCTTGAGTTGTG	earlyEry
BM4_GCTTGGTCACAC	Mono
BM4_GCTTGTTAGGAC	T
BM4_GCTTTAAGCCCC	GMP
BM4_GCTTTGTCGTTN	Prog
BM4_GCTTTTATAACN	T
BM4_GCTTTTGGCCAT	Plasma
BM4_GGAAAAGATGGC	Prog
BM4_GGAAAAGCAAGT	T
BM4_GGAAAAGTAAAG	Prog
BM4_GGAAAATTCGCT	Prog
BM4_GGAAACCCTTTG	ProMono
BM4_GGAAAGCTGGAA	Mono
BM4_GGAAAGGTTGGN	earlyEry
BM4_GGAAATGACGTG	earlyEry
BM4_GGAACCGATTGC	earlyEry
BM4_GGAACCTAAGTN	CTL
BM4_GGAACTACCACG	earlyEry
BM4_GGAAGATCTGCN	ProMono
BM4_GGAAGCCGGTTA	CTL
BM4_GGAAGGAGCTCN	B
BM4_GGAAGGTCTCTC	ProB
BM4_GGAATACAGATT	NK
BM4_GGAATGGATATA	NK
BM4_GGAATTAGTCCN	Mono
BM4_GGAATTATTTAN	earlyEry
BM4_GGAATTCTATTG	ProMono
BM4_GGAATTGGTGGT	T
BM4_GGAATTTATTTA	earlyEry
BM4_GGACACTCATTA	ProMono
BM4_GGACATGCGACN	pDC
BM4_GGACCGGCAGTC	Mono
BM4_GGACGACACATN	GMP
BM4_GGACGACCCCGG	ProMono
BM4_GGACGCTGCACC	Prog
BM4_GGACGGGTGTTT	Prog
BM4_GGACGTAAAGTG	lateEry
BM4_GGACGTCTGCCC	cDC
BM4_GGACGTTCTGGN	Mono
BM4_GGACTCTAAGTG	pDC
BM4_GGACTGCCAGAT	T
BM4_GGACTGGCCCAN	T
BM4_GGACTTCTGATN	CTL
BM4_GGACTTGGAGAA	cDC
BM4_GGACTTTAATAA	GMP
BM4_GGAGAAATGAGC	cDC
BM4_GGAGAAGCGCTA	T
BM4_GGAGAAGCGGAA	ProMono
BM4_GGAGACTTTACN	Prog
BM4_GGAGATGAGGAN	T
BM4_GGAGATGTACTG	Prog
BM4_GGAGCGGGGTGG	Prog
BM4_GGAGCTGTTGGN	CTL
BM4_GGAGGACACTTG	ProMono
BM4_GGAGGAGCTCTA	CTL
BM4_GGAGGCGTCAGC	lateEry
BM4_GGAGGTAAAGTC	Mono
BM4_GGAGTAGAGCTC	earlyEry
BM4_GGAGTAGGTAAT	T
BM4_GGAGTGGTGTGC	ProMono
BM4_GGAGTTCTTCCA	ProMono
BM4_GGAGTTTGACGN	earlyEry
BM4_GGATAGCCGATN	GMP
BM4_GGATCACAGCCN	CTL
BM4_GGATCAGAAGCG	GMP
BM4_GGATCTGTCTCG	GMP
BM4_GGATGAGCTCTT	T
BM4_GGATGCGTCCCT	Mono
BM4_GGATGGACCATN	Prog
BM4_GGATGGGTCGAT	earlyEry
BM4_GGATGGTCCCTN	Mono
BM4_GGATGTAACTAT	GMP
BM4_GGATTAGCCGAT	GMP
BM4_GGATTCAGCCCC	Mono
BM4_GGATTGGACCAT	GMP
BM4_GGCAAATGGGCC	T
BM4_GGCAACGCTCCN	Prog
BM4_GGCAACGTTTTC	lateEry
BM4_GGCAAGGCCCCN	GMP
BM4_GGCAAGGCGTAC	T
BM4_GGCAAGGGAGTT	CTL
BM4_GGCAATTGGCTA	ProB
BM4_GGCACACGGTGC	GMP
BM4_GGCACATCGTAC	earlyEry
BM4_GGCACATGTGTG	earlyEry
BM4_GGCACCATCGCA	earlyEry
BM4_GGCACGCCGCCT	NK
BM4_GGCACGTCGATN	Prog
BM4_GGCACTTCACCG	earlyEry
BM4_GGCACTTCGGCC	Mono
BM4_GGCAGATGTAAA	Mono
BM4_GGCAGCTAAGAA	earlyEry
BM4_GGCAGGTCTAAA	Prog
BM4_GGCAGGTTATTN	T
BM4_GGCATCCGGGTA	Prog
BM4_GGCATCTCTCAT	T
BM4_GGCATTCGCATC	Mono
BM4_GGCATTCGTCGT	Prog
BM4_GGCATTCTGTTT	GMP
BM4_GGCCACAGGGTC	T
BM4_GGCCCAAAGGGA	lateEry
BM4_GGCCCAAGATGC	Prog
BM4_GGCCCCGTTTTT	GMP
BM4_GGCCCGCCAACT	Mono
BM4_GGCCCTGTGGCG	T
BM4_GGCCGAGGTTCA	Prog
BM4_GGCCGCTCAGGG	Mono
BM4_GGCCGCTGTAGT	GMP
BM4_GGCCGGAAGTGT	lateEry
BM4_GGCCTACGCTCC	Mono
BM4_GGCCTATCACAG	ProMono
BM4_GGCGAGACGCAA	Prog
BM4_GGCGAGTTTTGA	Mono
BM4_GGCGATGGTATG	T
BM4_GGCGCGCACAGG	NK
BM4_GGCGCTATCAAG	Mono
BM4_GGCGCTCATCTA	earlyEry
BM4_GGCGGACTGCTN	Prog
BM4_GGCGGAGTCGCG	GMP
BM4_GGCGGGACTCCA	GMP
BM4_GGCGTCTAACCN	earlyEry
BM4_GGCGTTAAACCC	GMP
BM4_GGCGTTCACCTA	ProMono
BM4_GGCGTTTGATGG	lateEry
BM4_GGCTAAGCACCN	Mono
BM4_GGCTAGAACGAT	CTL
BM4_GGCTCAGTTCAA	T
BM4_GGCTCTCAAGAC	earlyEry
BM4_GGCTCTGCTCCC	Mono
BM4_GGCTGAGATTTG	HSC
BM4_GGCTGGAGGAGA	pDC
BM4_GGCTTAGGCAGN	Mono
BM4_GGCTTGTGTTTG	B
BM4_GGCTTTTACTAN	earlyEry
BM4_GGGAAAATGTGN	Mono
BM4_GGGAAACTCCCA	ProMono
BM4_GGGAACAGAACN	T
BM4_GGGAACGAATTN	T
BM4_GGGAAGAGACCN	lateEry
BM4_GGGAAGCCGATT	Mono
BM4_GGGAAGGCGGGG	earlyEry
BM4_GGGAATGGTAGN	ProMono
BM4_GGGACATCGAGG	ProMono
BM4_GGGACATGCCGN	ProMono
BM4_GGGACCTTTTGG	ProMono
BM4_GGGACGACTCAT	Mono
BM4_GGGACGCGCGTC	lateEry
BM4_GGGACTTTCGCT	earlyEry
BM4_GGGAGCGGATTC	cDC
BM4_GGGAGCGTTAAN	T
BM4_GGGAGCTTCTAC	ProMono
BM4_GGGAGTCGTGAC	Prog
BM4_GGGATCATGCCG	ProMono
BM4_GGGATGGTCGGG	ProMono
BM4_GGGCACCGGGCT	ProMono
BM4_GGGCACTCGGGA	Prog
BM4_GGGCAGCTTAGG	lateEry
BM4_GGGCATGTCGGN	CTL
BM4_GGGCATTCGCTN	lateEry
BM4_GGGCCCAGCGGG	cDC
BM4_GGGCCTCGAACA	Prog
BM4_GGGCCTCTTATC	CTL
BM4_GGGCCTTACCCC	CTL
BM4_GGGCGATTGAGG	HSC
BM4_GGGCGCCTTTCG	Mono
BM4_GGGCGGTTCGCA	GMP
BM4_GGGCGTAGTCTN	cDC
BM4_GGGCGTCCCGCT	Prog
BM4_GGGCGTGACATG	Prog
BM4_GGGCTCAAAGAC	Prog
BM4_GGGCTCGCACAG	lateEry
BM4_GGGCTCTCGGCN	earlyEry
BM4_GGGCTGACTGTC	GMP
BM4_GGGCTGCCATTC	GMP
BM4_GGGCTTGCTCCG	Prog
BM4_GGGCTTTGTTAG	GMP
BM4_GGGGCATGCAGN	GMP
BM4_GGGGCCAAATGT	GMP
BM4_GGGGCGAGCTCG	cDC
BM4_GGGGTACCAGTT	GMP
BM4_GGGGTCTACCGG	GMP
BM4_GGGGTTTCATAT	earlyEry
BM4_GGGTAACAGTCC	lateEry
BM4_GGGTAGGACCCT	Prog
BM4_GGGTATCTTGGN	GMP
BM4_GGGTCACGCGTN	Mono
BM4_GGGTCCAGGGTN	ProB
BM4_GGGTCGGCGACG	ProMono
BM4_GGGTCGGCTGAA	T
BM4_GGGTCGTCTACN	GMP
BM4_GGGTGAGGTCAG	earlyEry
BM4_GGGTGCGAATCC	ProMono
BM4_GGGTGCTGCTTC	NK
BM4_GGGTGGTAGGAT	lateEry
BM4_GGGTGGTTAGTA	Mono
BM4_GGGTGTTTTTTA	ProMono
BM4_GGGTTAGACGTT	GMP
BM4_GGGTTAGAGACT	cDC
BM4_GGGTTAGAGCTN	cDC
BM4_GGGTTATTGGAN	Mono
BM4_GGGTTCGGAACN	ProMono
BM4_GGGTTGTCCGCN	earlyEry
BM4_GGGTTGTTTAGC	ProMono
BM4_GGTAAAACCTTC	CTL
BM4_GGTAAACAACTG	CTL
BM4_GGTAAATCCATN	ProB
BM4_GGTAAGATGAGN	GMP
BM4_GGTAATATGCAC	GMP
BM4_GGTAATTAGAAC	Prog
BM4_GGTAATTGCGTN	T
BM4_GGTAATTTGGGN	GMP
BM4_GGTACCGCACGG	GMP
BM4_GGTACGTACGTC	ProMono
BM4_GGTACTGTAGTC	ProMono
BM4_GGTAGCCGCAAN	ProMono
BM4_GGTAGCCGCCTN	Mono
BM4_GGTAGTAGCGTT	T
BM4_GGTAGTGCTCGT	ProMono
BM4_GGTATAATGCGT	ProMono
BM4_GGTCAAACTACG	earlyEry
BM4_GGTCATACTTAG	earlyEry
BM4_GGTCATCTTGCT	GMP
BM4_GGTCCAGCCCCG	CTL
BM4_GGTCCCAAAGGG	earlyEry
BM4_GGTCCCGCAGAT	CTL
BM4_GGTCCTTACCGN	NK
BM4_GGTCGAGCGCGG	earlyEry
BM4_GGTCTAGTTGCT	CTL
BM4_GGTCTGCGTGGA	earlyEry
BM4_GGTGAATGAACN	earlyEry
BM4_GGTGAGAGAACG	B
BM4_GGTGAGATGTTC	T
BM4_GGTGATCTGCCT	earlyEry
BM4_GGTGCTCGCTTG	earlyEry
BM4_GGTGCTCGTCCC	Mono
BM4_GGTGCTCTCGCN	Prog
BM4_GGTGCTGCTCAT	T
BM4_GGTGGCTAACCG	Prog
BM4_GGTGTATTTAGN	Mono
BM4_GGTGTCTACTCN	Prog
BM4_GGTGTCTCTCGC	Prog
BM4_GGTGTGCATGAT	Plasma
BM4_GGTGTGCCCGAN	B
BM4_GGTGTGTCATAN	ProMono
BM4_GGTGTTCCGTAA	ProMono
BM4_GGTGTTCGTGCN	ProMono
BM4_GGTGTTCGTGTC	ProMono
BM4_GGTGTTGCTTTG	NK
BM4_GGTGTTGTGTAT	cDC
BM4_GGTGTTTTGGGN	Mono
BM4_GGTGTTTTTGGG	earlyEry
BM4_GGTTAAAAATTT	CTL
BM4_GGTTAACGAGGA	Plasma
BM4_GGTTCAAGGTGC	cDC
BM4_GGTTCCATGGCC	earlyEry
BM4_GGTTCGACGATN	T
BM4_GGTTGATATCTT	CTL
BM4_GGTTTAAATTGA	cDC
BM4_GGTTTCCTCGAT	GMP
BM4_GGTTTGGTCTTN	Mono
BM4_GGTTTGTAGACC	Mono
BM4_GGTTTTATCGGN	CTL
BM4_GTAAAATGCTTA	GMP
BM4_GTAAAGGAGCTG	GMP
BM4_GTAAAGGCAGTC	Mono
BM4_GTAAAGTACAGA	CTL
BM4_GTAAATCGATGN	ProB
BM4_GTAAATCGGCAA	earlyEry
BM4_GTAACATAGCAC	earlyEry
BM4_GTAACCCCCCGN	CTL
BM4_GTAACCCTCCGN	earlyEry
BM4_GTAACGACCGAN	Mono
BM4_GTAACGCTGGTA	Mono
BM4_GTAAGAACATCT	Mono
BM4_GTAAGCTGCAAN	T
BM4_GTAAGCTTGCTA	Mono
BM4_GTAAGGCCGGGN	Mono
BM4_GTAAGGCGTGCG	NK
BM4_GTAAGTACAAGT	Prog
BM4_GTAAGTCTCCGG	earlyEry
BM4_GTAAGTGCTCTC	T
BM4_GTAAGTTGCGAG	earlyEry
BM4_GTAATCCCTCCG	earlyEry
BM4_GTACAACCTACA	GMP
BM4_GTACACAGGATN	Mono
BM4_GTACACCTCAAA	earlyEry
BM4_GTACACGTTTTT	ProMono
BM4_GTACACTAAATA	Prog
BM4_GTACCAGCGCTG	Prog
BM4_GTACGAACTAGC	NK
BM4_GTACGTGTATAC	NK
BM4_GTACTAAATAGC	earlyEry
BM4_GTACTGTATGCN	earlyEry
BM4_GTAGAACAGCAN	ProMono
BM4_GTAGAGCTGGGA	ProMono
BM4_GTAGAGGGGGCN	earlyEry
BM4_GTAGCCGTTCAN	NK
BM4_GTAGCGCCCTGC	ProMono
BM4_GTAGGAGCTCGN	earlyEry
BM4_GTAGGATAAGTA	T
BM4_GTAGGCCGACCC	Mono
BM4_GTAGGGAAATTG	Prog
BM4_GTAGGTAGGTAA	Prog
BM4_GTAGGTGTCTTC	Prog
BM4_GTAGTGTGGTCT	CTL
BM4_GTATAGCAGACN	Prog
BM4_GTATCACTTTTC	Prog
BM4_GTATCCAAGGGT	T
BM4_GTATGGGGCCAG	Prog
BM4_GTATGGTCGATC	T
BM4_GTATGTCACGCA	earlyEry
BM4_GTATGTCCATTG	Prog
BM4_GTATTAGCACGG	earlyEry
BM4_GTATTGCAATTT	ProMono
BM4_GTATTTAGTTAA	ProB
BM4_GTATTTCGGTGC	T
BM4_GTCAAACTTTCA	Mono
BM4_GTCAAAGACTGG	ProB
BM4_GTCAAATGTGAC	ProMono
BM4_GTCAACCAAACN	B
BM4_GTCAAGCGGTAC	Prog
BM4_GTCAAGGACTGC	Plasma
BM4_GTCAATAAGGAA	ProMono
BM4_GTCAATAGTGGT	lateEry
BM4_GTCACCAGCACC	ProMono
BM4_GTCACCTGACGG	ProMono
BM4_GTCACCTTCGTG	NK
BM4_GTCACGGCTCGT	cDC
BM4_GTCACGGTAACG	CTL
BM4_GTCAGAAGTTTN	Prog
BM4_GTCAGATCTCGC	ProMono
BM4_GTCAGCTAGCTT	Mono
BM4_GTCAGGCTCGTN	cDC
BM4_GTCATCGGCGGT	earlyEry
BM4_GTCATGTCGCCG	T
BM4_GTCCAAACTACA	Plasma
BM4_GTCCCATGCTCA	ProMono
BM4_GTCCCGGGTGGC	earlyEry
BM4_GTCCGCAAGCCN	CTL
BM4_GTCCGCCACGTA	ProMono
BM4_GTCCGTATCTTN	cDC
BM4_GTCCGTGTACGT	T
BM4_GTCCGTGTAGTG	T
BM4_GTCCGTTCACAN	ProMono
BM4_GTCCGTTGAGCT	Plasma
BM4_GTCCTAGCCCGT	GMP
BM4_GTCCTCCTCCGN	earlyEry
BM4_GTCCTGGAACCA	GMP
BM4_GTCCTTATGTAG	ProMono
BM4_GTCGAAGCGGTG	Mono
BM4_GTCGACCCGTCG	cDC
BM4_GTCGAGAGACCT	T
BM4_GTCGATTCGTTT	cDC
BM4_GTCGATTTGATA	ProMono
BM4_GTCGCAAAGAAG	T
BM4_GTCGCCCCGTAT	CTL
BM4_GTCGCGCTGGTC	earlyEry
BM4_GTCGGGAATATG	Mono
BM4_GTCGGTCCAGAN	ProMono
BM4_GTCGGTGAGTCT	B
BM4_GTCGTAAATATA	T
BM4_GTCGTAACAAGC	Prog
BM4_GTCGTGCATAAC	ProMono
BM4_GTCTACGACATN	Plasma
BM4_GTCTACGCGCCT	ProMono
BM4_GTCTCAGTGTAN	Mono
BM4_GTCTCGGTAGAA	T
BM4_GTCTCGGTGGCG	earlyEry
BM4_GTCTCTGTTGTN	T
BM4_GTCTGAGTCACA	Mono
BM4_GTCTGATCAAGA	earlyEry
BM4_GTCTTAGTACAN	CTL
BM4_GTCTTAGTCTGG	CTL
BM4_GTCTTGGATATN	T
BM4_GTCTTGGCCTTC	Plasma
BM4_GTCTTTAAACGG	Prog
BM4_GTCTTTCAGCAG	Mono
BM4_GTCTTTGGTTGT	Prog
BM4_GTGAAGGTGCGT	T
BM4_GTGAATGACCTN	Mono
BM4_GTGACATCGACT	Prog
BM4_GTGACCGTCAGG	Mono
BM4_GTGAGAAGGGCA	earlyEry
BM4_GTGAGAGGATCN	ProB
BM4_GTGAGGAAGTCC	GMP
BM4_GTGAGGATCACA	HSC
BM4_GTGAGTAAGGAN	GMP
BM4_GTGAGTCTGGGN	Mono
BM4_GTGATGAGAAAA	B
BM4_GTGATGCCACAN	ProB
BM4_GTGATTAGTGGA	earlyEry
BM4_GTGATTCTTTAT	T
BM4_GTGCAAAGTGGC	T
BM4_GTGCACTTAAGN	earlyEry
BM4_GTGCAGTCGCGC	Mono
BM4_GTGCATATCCAC	cDC
BM4_GTGCCACCAACC	T
BM4_GTGCCATAGCTN	Mono
BM4_GTGCCCTGGAAG	earlyEry
BM4_GTGCCTATCGCA	earlyEry
BM4_GTGCGCGCCTGT	ProMono
BM4_GTGCGTAGTGTG	earlyEry
BM4_GTGCGTTGCATT	earlyEry
BM4_GTGCTGACCTCN	ProB
BM4_GTGCTGCGTTAG	ProMono
BM4_GTGCTTGACCTC	ProB
BM4_GTGGACCGACCN	ProMono
BM4_GTGGACGTGTAT	Mono
BM4_GTGGAGCACTTT	T
BM4_GTGGCAACTAGN	lateEry
BM4_GTGGCAGCCTGC	CTL
BM4_GTGGCAGCGCCT	GMP
BM4_GTGGCATTGCGG	cDC
BM4_GTGGCGGAGACN	ProMono
BM4_GTGGCGTTATAG	GMP
BM4_GTGGCTAAAGCN	earlyEry
BM4_GTGGCTCCGCTN	Prog
BM4_GTGGCTCGTCCT	ProMono
BM4_GTGGCTTTTTCN	T
BM4_GTGGGAGACCTN	GMP
BM4_GTGGGCAGGAGN	Mono
BM4_GTGGGCCACTTT	GMP
BM4_GTGGGCCTCGCA	T
BM4_GTGGGTGCCCCT	CTL
BM4_GTGGTAACATAN	earlyEry
BM4_GTGGTCCTATCG	lateEry
BM4_GTGGTGAGACCT	GMP
BM4_GTGGTGATTGGN	earlyEry
BM4_GTGGTGCTGTAA	Plasma
BM4_GTGGTTCATCAN	ProMono
BM4_GTGGTTGTGTCG	lateEry
BM4_GTGGTTTCATCA	ProMono
BM4_GTGGTTTCTTCC	ProMono
BM4_GTGTAGATCGGC	CTL
BM4_GTGTAGGAGTTG	NK
BM4_GTGTATGACGCN	earlyEry
BM4_GTGTCCCGGTAG	NK
BM4_GTGTCTAATGTN	GMP
BM4_GTGTGGCTGAGN	NK
BM4_GTGTGGGGGCGG	ProMono
BM4_GTGTTCAACCAA	Prog
BM4_GTGTTCGAGTGA	T
BM4_GTGTTGTGCAAT	ProB
BM4_GTGTTGTTATAN	earlyEry
BM4_GTGTTTTATCAT	Mono
BM4_GTTAACCGCAAT	earlyEry
BM4_GTTAAGGTGGTA	lateEry
BM4_GTTAAGTCTTCG	T
BM4_GTTAATGTTTTT	B
BM4_GTTACTGTCTGA	pDC
BM4_GTTAGAAGTCTT	ProMono
BM4_GTTAGGGTGCAN	cDC
BM4_GTTAGTCCTCAN	GMP
BM4_GTTATCGAAAAG	Prog
BM4_GTTATGTACCGG	cDC
BM4_GTTATTACAAGN	T
BM4_GTTCAAGATCCT	NK
BM4_GTTCAGGCATGN	earlyEry
BM4_GTTCCATCGAGT	T
BM4_GTTCCCGAGGTG	ProMono
BM4_GTTCCGATTTGN	Plasma
BM4_GTTCCGCCTAGT	NK
BM4_GTTCCGTAGATG	earlyEry
BM4_GTTCGTCGCAAG	T
BM4_GTTCGTTCTGGN	T
BM4_GTTCTAGTCTAN	T
BM4_GTTCTCGTTGAA	Prog
BM4_GTTCTTTGAAGG	GMP
BM4_GTTGACTGGAGT	GMP
BM4_GTTGAGGCATTG	earlyEry
BM4_GTTGAGTAAGGA	GMP
BM4_GTTGAGTGGAAN	NK
BM4_GTTGATTTGACT	Prog
BM4_GTTGCGATAGCA	Prog
BM4_GTTGCGCAGACG	ProMono
BM4_GTTGCGCGTGTT	NK
BM4_GTTGCGCTTCAA	NK
BM4_GTTGGAAATCAA	GMP
BM4_GTTGGAAGTAAC	cDC
BM4_GTTGGGATATTC	CTL
BM4_GTTGGGCGAGTC	B
BM4_GTTGGTCCCCCG	Prog
BM4_GTTGTATACGCA	CTL
BM4_GTTGTATCTAGA	ProMono
BM4_GTTGTCGCAGCG	ProMono
BM4_GTTGTCTGGTCN	cDC
BM4_GTTGTGGACTGN	lateEry
BM4_GTTGTTGGACTG	lateEry
BM4_GTTTAAGTGTTG	ProMono
BM4_GTTTAATCTGAN	T
BM4_GTTTATATAACG	Mono
BM4_GTTTATTTTCTT	B
BM4_GTTTCATCCGGT	lateEry
BM4_GTTTCGTGGTTN	T
BM4_GTTTCTTAGAAN	Prog
BM4_GTTTGGGCCAAG	T
BM4_GTTTGTTAATTN	T
BM4_GTTTGTTTGCTG	Mono
BM4_GTTTTCATGCCC	Prog
BM4_GTTTTTAGAGAA	T
BM4_GTTTTTCATACT	T
BM4_GTTTTTTTCGAN	NK
BM4_TAAAAGGAGTCN	ProMono
BM4_TAAAATATTTTA	ProMono
BM4_TAAACACCCTTG	earlyEry
BM4_TAAACGGTGCCC	CTL
BM4_TAAACTTCTAGN	Plasma
BM4_TAAAGAGAGCAT	T
BM4_TAAAGATTGTTA	GMP
BM4_TAAAGCGTGGCA	ProB
BM4_TAAAGTGTTGGC	Mono
BM4_TAAAGTTGTGTG	Prog
BM4_TAAATCGCGAGG	earlyEry
BM4_TAAATTGGCTGA	cDC
BM4_TAACACCCATGG	lateEry
BM4_TAACACCCTAGN	T
BM4_TAACAGATGGTN	GMP
BM4_TAACATCTGTCN	B
BM4_TAACCAGCTGAN	T
BM4_TAACCGGCGCGT	earlyEry
BM4_TAACCTGAACCN	T
BM4_TAACCTTGAGTG	Mono
BM4_TAACGACCAGGA	GMP
BM4_TAACGTAATCGC	T
BM4_TAACTCGAGGAC	cDC
BM4_TAACTTGTCCCC	ProMono
BM4_TAAGACGGCTTT	CTL
BM4_TAAGAGATTATC	ProMono
BM4_TAAGAGCATGAN	NK
BM4_TAAGCATCCTGN	T
BM4_TAAGCCCGGTCN	Mono
BM4_TAAGGAGTCTCN	T
BM4_TAAGGCAGGACG	Mono
BM4_TAAGGCGATGCA	cDC
BM4_TAAGTCAGAGCA	CTL
BM4_TAAGTCCCGTAG	T
BM4_TAAGTTCGTTTT	T
BM4_TAAGTTGATCAG	Mono
BM4_TAATACAAGGTC	lateEry
BM4_TAATAGACGGTN	cDC
BM4_TAATAGTCGCAA	T
BM4_TAATAGTTAGTC	ProMono
BM4_TAATATGAACAG	NK
BM4_TAATCACGCTAT	lateEry
BM4_TAATGAATCGCG	CTL
BM4_TAATGTGTATAC	GMP
BM4_TAATTAGAGCGN	Mono
BM4_TAATTAGTTTGT	Prog
BM4_TAATTCACATCC	T
BM4_TAATTGGAAATT	earlyEry
BM4_TAATTTTTGTTA	lateEry
BM4_TACAAGCCCGTC	ProMono
BM4_TACAATTGATTG	Mono
BM4_TACACCACGAAN	ProMono
BM4_TACACCGAATAG	T
BM4_TACACGCTAGCN	NK
BM4_TACACGTTTGTG	T
BM4_TACACTATTAGA	ProMono
BM4_TACACTCAAGAC	pDC
BM4_TACAGATTAAAT	Mono
BM4_TACAGGATTATC	T
BM4_TACAGGTTATCG	T
BM4_TACAGTGGTTGN	T
BM4_TACATAGTCGAG	HSC
BM4_TACATCAAATTG	T
BM4_TACATGGAAGCG	Mono
BM4_TACCCAATTCCG	Prog
BM4_TACCCCCGCGCN	earlyEry
BM4_TACCCGAGTCCT	cDC
BM4_TACCCGCCGACG	ProMono
BM4_TACCGAAATCTC	GMP
BM4_TACCGGCGGAAT	cDC
BM4_TACCGGGAGCCT	Mono
BM4_TACCGTATGTTA	pDC
BM4_TACCTTTATGTN	T
BM4_TACGAGGGATGN	Prog
BM4_TACGCATTTGTT	GMP
BM4_TACGCCATCAGN	T
BM4_TACGCGCAGTTC	pDC
BM4_TACGCTGAAATN	Mono
BM4_TACGGCGTGTTC	lateEry
BM4_TACGTACCTAGC	earlyEry
BM4_TACGTATTATGN	T
BM4_TACGTTGTTCTT	T
BM4_TACTACTTGACC	CTL
BM4_TACTATAGGTGC	ProMono
BM4_TACTCACGAGCN	earlyEry
BM4_TACTCTTGGAGN	T
BM4_TACTGCGAATAA	GMP
BM4_TACTGGAACAGN	Prog
BM4_TACTTAGAGAGA	Mono
BM4_TACTTAGGGTGA	GMP
BM4_TACTTATAAGGN	Prog
BM4_TACTTCCCGGCN	cDC
BM4_TACTTGGAGTCT	T
BM4_TACTTTCGGGAN	Mono
BM4_TAGAAATTAAGT	T
BM4_TAGAAGAGAACA	ProMono
BM4_TAGAAGCTGACC	B
BM4_TAGAAGTTGCTA	GMP
BM4_TAGAATGCCCAG	Prog
BM4_TAGAATTATTCN	CTL
BM4_TAGACAATCTCG	GMP
BM4_TAGACGCGGCTC	Mono
BM4_TAGACGGCATTC	ProMono
BM4_TAGACGTTCGGC	Mono
BM4_TAGACTAGATGA	Prog
BM4_TAGAGGTGCTCG	GMP
BM4_TAGAGTGGGGCT	Mono
BM4_TAGATACTCTAC	ProMono
BM4_TAGATTCACCGA	Plasma
BM4_TAGCAAGGATAC	cDC
BM4_TAGCATCCGTGA	GMP
BM4_TAGCCATCAAAN	ProMono
BM4_TAGCCCTTCGTT	Prog
BM4_TAGCTCATGGAC	T
BM4_TAGCTGGGCTAT	GMP
BM4_TAGGAAGCTGTC	earlyEry
BM4_TAGGACCTACAC	GMP
BM4_TAGGCAAACTGT	CTL
BM4_TAGGCGAAACTN	T
BM4_TAGGGCGCTACC	CTL
BM4_TAGGGGTTCGCA	ProMono
BM4_TAGGTAAGATCA	Prog
BM4_TAGGTAGTATGG	NK
BM4_TAGGTATATCGN	T
BM4_TAGGTGAAGTGA	cDC
BM4_TAGGTGCGTGAT	lateEry
BM4_TAGGTTATCGAG	earlyEry
BM4_TAGGTTGGCGGT	Prog
BM4_TAGTAGTCTCTG	GMP
BM4_TAGTATAAACAN	ProMono
BM4_TAGTCACTTTAN	GMP
BM4_TAGTCACTTTTA	GMP
BM4_TAGTCCTAATTG	cDC
BM4_TAGTCTGTGTGT	CTL
BM4_TAGTGCTGCGTA	Mono
BM4_TAGTGGTCGGTT	T
BM4_TAGTGTATGCTG	NK
BM4_TAGTTCACGTAA	T
BM4_TAGTTGCTGGTT	T
BM4_TAGTTGGCGGCN	pDC
BM4_TAGTTTAGTTCN	CTL
BM4_TAGTTTATCCTG	Prog
BM4_TAGTTTCACCTA	pDC
BM4_TAGTTTCCGTCG	CTL
BM4_TAGTTTTCTAGG	earlyEry
BM4_TATAAAGTCCTC	T
BM4_TATAAATGGATC	T
BM4_TATAACCAAGTN	Prog
BM4_TATACCAGCGCN	Prog
BM4_TATACGACATTT	T
BM4_TATACTTGAGCN	CTL
BM4_TATAGCCGCGCC	T
BM4_TATATAAGGGAN	T
BM4_TATCACGTACGN	ProMono
BM4_TATCAGCTCATC	GMP
BM4_TATCAGGGCGGT	ProMono
BM4_TATCAGGTCCTA	T
BM4_TATCCGTAACAN	earlyEry
BM4_TATCCTAGTAAN	ProMono
BM4_TATCGAATTGCT	T
BM4_TATCGATAGGTC	Prog
BM4_TATCGATCTTTG	CTL
BM4_TATCGCAACCGA	ProMono
BM4_TATCGGTATACT	lateEry
BM4_TATCGTAAGGGT	ProMono
BM4_TATCGTGTGATN	Prog
BM4_TATCTACCCTGA	Mono
BM4_TATCTGAAATAC	T
BM4_TATCTGTTCCGG	Prog
BM4_TATGCCCCTAGT	ProB
BM4_TATGGAATTCTG	Mono
BM4_TATGGAGTGCTA	cDC
BM4_TATGGCTGGAGT	T
BM4_TATGGGCACTTN	T
BM4_TATGGTGGGAGN	earlyEry
BM4_TATGTAAGAGTN	CTL
BM4_TATGTACTATGN	GMP
BM4_TATGTAGTTTCG	Prog
BM4_TATGTATCTGGA	T
BM4_TATGTATTCCCT	Mono
BM4_TATGTCCGTACG	earlyEry
BM4_TATGTCGGGGTT	T
BM4_TATGTGATGTTT	earlyEry
BM4_TATGTTTGTACT	ProMono
BM4_TATTAGAGATGN	lateEry
BM4_TATTAGATCCAN	T
BM4_TATTCTAGTAGG	T
BM4_TATTCTCGACCN	CTL
BM4_TATTGAGGATCT	Mono
BM4_TATTGATGTTTN	T
BM4_TATTGATTGAAT	T
BM4_TATTGTGAGACN	T
BM4_TATTGTTACGGG	cDC
BM4_TATTGTTTGTTN	ProMono
BM4_TATTTAGATCCG	ProMono
BM4_TATTTTAAGCAN	T
BM4_TATTTTGATTAA	GMP
BM4_TCAAAATCCTTN	ProMono
BM4_TCAAACATGCTG	ProMono
BM4_TCAAAGTATAGG	Plasma
BM4_TCAAATACTCAN	Prog
BM4_TCAACAGCTTTT	ProMono
BM4_TCAACAGTATTN	GMP
BM4_TCAACGACGTAG	earlyEry
BM4_TCAACGCTCGGG	CTL
BM4_TCAACGTTCAAG	ProMono
BM4_TCAACTCGGAAA	GMP
BM4_TCAACTGCCGGT	earlyEry
BM4_TCAACTGGTGAT	NK
BM4_TCAAGCCGTATG	Plasma
BM4_TCAAGGTTTACG	Mono
BM4_TCAATAGGACTN	GMP
BM4_TCAATGTATGTG	Prog
BM4_TCACCACCGTGC	T
BM4_TCACCAGACGCN	pDC
BM4_TCACCCGATTGG	Prog
BM4_TCACGAATTCGG	T
BM4_TCACGATCACTC	lateEry
BM4_TCACGGGTCACA	Prog
BM4_TCACGGTAGCCA	T
BM4_TCACGTCCGCAN	earlyEry
BM4_TCACGTGGGTAA	cDC
BM4_TCAGAAGGTGGC	cDC
BM4_TCAGAGGAATTN	Prog
BM4_TCAGCAGGAAAN	Mono
BM4_TCAGCCTGGGGA	ProB
BM4_TCAGCGCCTCCA	B
BM4_TCAGCTGTATTT	Plasma
BM4_TCAGCTTGGTGT	T
BM4_TCAGTAGATCAN	Prog
BM4_TCAGTAGCCGTN	lateEry
BM4_TCAGTGCAATAA	Prog
BM4_TCAGTTTGTGTA	CTL
BM4_TCATAGCATTGT	Mono
BM4_TCATCGGGAGAG	earlyEry
BM4_TCATGCTTACTN	cDC
BM4_TCATGCTTTCGN	GMP
BM4_TCATGTCACAAN	Prog
BM4_TCATGTCGTACN	GMP
BM4_TCATTCTATTCN	GMP
BM4_TCATTGCACCAN	ProMono
BM4_TCATTGCACCCA	ProMono
BM4_TCATTTTTGGTN	GMP
BM4_TCCAAAGGCCAT	cDC
BM4_TCCACAGTATAC	ProMono
BM4_TCCACCGTTGGT	ProMono
BM4_TCCACTGAGGGG	ProMono
BM4_TCCAGGAGGAAT	T
BM4_TCCAGTAGTCGG	ProMono
BM4_TCCAGTCATATA	Prog
BM4_TCCAGTGTCGTG	T
BM4_TCCAGTTATGAN	earlyEry
BM4_TCCATGGCGAGC	Mono
BM4_TCCATGGGGTTT	Prog
BM4_TCCATGTTGTTN	T
BM4_TCCCAAGTAGCG	T
BM4_TCCCAGTGCCAN	lateEry
BM4_TCCCATTTGCCG	NK
BM4_TCCCCAGCGGTT	GMP
BM4_TCCCCATGTGCT	Prog
BM4_TCCCCCACCGGC	CTL
BM4_TCCCCCCGTAAN	GMP
BM4_TCCCCGTTGGCT	earlyEry
BM4_TCCCCTCCGTAA	GMP
BM4_TCCCCTCGTACC	T
BM4_TCCCCTTCGGCG	T
BM4_TCCCCTTGACGT	Mono
BM4_TCCCCTTGAGTN	Mono
BM4_TCCCCTTGGCTN	earlyEry
BM4_TCCCCTTGTGCN	ProMono
BM4_TCCCGATTATCA	pDC
BM4_TCCCGTCAGTAT	T
BM4_TCCCTCTTCGAG	HSC
BM4_TCCCTGAATGCN	GMP
BM4_TCCCTGATAAGC	Mono
BM4_TCCCTTCGTGCN	Prog
BM4_TCCGAGGTCGCN	ProMono
BM4_TCCGCAGGCGTG	T
BM4_TCCGCCCACGCT	NK
BM4_TCCGCCCACTCN	cDC
BM4_TCCGCGCGTTGC	Prog
BM4_TCCGCGTGTGAN	earlyEry
BM4_TCCGCTGGATTC	pDC
BM4_TCCGGACGGTCG	earlyEry
BM4_TCCGGCCTCCCG	earlyEry
BM4_TCCGGGCATATC	B
BM4_TCCGGGCTAACT	T
BM4_TCCGGGGAATGT	B
BM4_TCCGTCATCTGT	GMP
BM4_TCCGTCGAGTTA	T
BM4_TCCGTCGTTAAG	Prog
BM4_TCCGTGCTAAGN	ProMono
BM4_TCCTAGGGGAAN	earlyEry
BM4_TCCTAGTCGCGT	GMP
BM4_TCCTGAGGTGAN	ProMono
BM4_TCCTGCCTGACN	cDC
BM4_TCCTGGACATGG	Prog
BM4_TCCTGTTGACAC	T
BM4_TCCTTAGCCGAG	T
BM4_TCCTTCAGACAC	ProMono
BM4_TCCTTCTTCTAN	T
BM4_TCCTTGCATGCA	Mono
BM4_TCCTTGCATTCG	earlyEry
BM4_TCCTTGCCTGAC	cDC
BM4_TCCTTTGATTGG	NK
BM4_TCGAACATTGAN	NK
BM4_TCGAACGGGAGA	Mono
BM4_TCGAACTCCCGN	GMP
BM4_TCGAACTTCCCG	GMP
BM4_TCGAAGACGACC	Prog
BM4_TCGACAGTGGAN	T
BM4_TCGAGAGAAGGN	ProMono
BM4_TCGAGAGAAGTG	ProMono
BM4_TCGAGATAAGCG	T
BM4_TCGAGCACGAAT	T
BM4_TCGAGCTGTTGT	T
BM4_TCGATCGCGTTA	T
BM4_TCGATCTGCCAA	T
BM4_TCGATGTATTCA	T
BM4_TCGATTTTCCTG	Prog
BM4_TCGCACATCGAA	CTL
BM4_TCGCCAGATTAC	T
BM4_TCGCCATCGTGG	Prog
BM4_TCGCCCCGCAGN	NK
BM4_TCGCGACTACTT	lateEry
BM4_TCGCGCTACCAN	earlyEry
BM4_TCGCGCTAGGAG	Mono
BM4_TCGCTACATGAG	cDC
BM4_TCGCTGCCGCAC	GMP
BM4_TCGCTGCTTGAN	ProMono
BM4_TCGGACGCCATN	CTL
BM4_TCGGATGGGGTA	lateEry
BM4_TCGGATTGTTTA	GMP
BM4_TCGGGAAGAGTC	ProB
BM4_TCGGGCATCGAT	lateEry
BM4_TCGGGTATGCAG	Mono
BM4_TCGGTCCGTCGC	ProB
BM4_TCGGTCCTTTTT	cDC
BM4_TCGGTCTCGTGA	ProMono
BM4_TCGGTGTCGCCA	Prog
BM4_TCGTAATGCAAG	Mono
BM4_TCGTAGTAATCG	T
BM4_TCGTATTGCTTT	ProMono
BM4_TCGTCAGGCGTC	GMP
BM4_TCGTCCAAGTGC	T
BM4_TCGTCCAATTAA	lateEry
BM4_TCGTCGGTATTG	T
BM4_TCGTCTCTTGAA	T
BM4_TCGTGTGTCAAA	GMP
BM4_TCGTTCCACTGA	ProMono
BM4_TCGTTCCGAGCG	earlyEry
BM4_TCGTTCGCAACT	cDC
BM4_TCGTTCGTTTAN	earlyEry
BM4_TCGTTCTGTTTA	earlyEry
BM4_TCGTTGATCACT	pDC
BM4_TCGTTTAGAGGG	cDC
BM4_TCGTTTGCCGGG	T
BM4_TCTAATCTCGGA	ProB
BM4_TCTACGGTTTTT	Mono
BM4_TCTAGCACGCAN	ProMono
BM4_TCTATAAACCGN	Mono
BM4_TCTATGTATGGC	GMP
BM4_TCTATGTCGTAC	GMP
BM4_TCTATTAATACN	B
BM4_TCTCACGCATTA	Prog
BM4_TCTCAGAAGAAT	T
BM4_TCTCCAGTTTGN	CTL
BM4_TCTCCCCGCGAG	T
BM4_TCTCCGCCCATT	CTL
BM4_TCTCGCAAGGGT	earlyEry
BM4_TCTCGGCGACGN	Mono
BM4_TCTCGGGTGGTN	Mono
BM4_TCTCGTATATCA	cDC
BM4_TCTCGTCTCGTA	Mono
BM4_TCTCTCAGCTAA	Prog
BM4_TCTCTCCGGAAG	earlyEry
BM4_TCTGAATCCTAN	CTL
BM4_TCTGACGTGGTN	GMP
BM4_TCTGAGAACCGA	lateEry
BM4_TCTGAGGCATCT	T
BM4_TCTGCTGATGAN	Mono
BM4_TCTGGATGAGTN	GMP
BM4_TCTGGGATGAGT	GMP
BM4_TCTGTTTTTACG	Prog
BM4_TCTTAATTGGCA	lateEry
BM4_TCTTATTATTTA	earlyEry
BM4_TCTTCCTCGCCA	T
BM4_TCTTCGAGGACC	T
BM4_TCTTCGTCTTCG	ProMono
BM4_TCTTCTCCCCCG	Prog
BM4_TCTTGCCTACAG	Mono
BM4_TCTTGCGGGTGN	earlyEry
BM4_TCTTTATCGCAN	ProB
BM4_TCTTTCCGTAAN	NK
BM4_TCTTTGCGCTGC	T
BM4_TCTTTTTACGTC	CTL
BM4_TGAAAAACTTTA	Mono
BM4_TGAAAACGAGTG	lateEry
BM4_TGAAAGAACATC	GMP
BM4_TGAAAGCCGAAA	ProMono
BM4_TGAAAGTTATCG	T
BM4_TGAACCGATCCC	ProB
BM4_TGAACTTAACGG	T
BM4_TGAACTTTTAGN	Prog
BM4_TGAACTTTTTAG	GMP
BM4_TGAAGACATCTC	NK
BM4_TGAAGAGTCAAA	Prog
BM4_TGAAGCAGTTGN	Mono
BM4_TGAAGCTGGTCC	earlyEry
BM4_TGAAGTGTCTCT	T
BM4_TGAATTCCCTCA	GMP
BM4_TGAATTGCACGN	T
BM4_TGACAATCAAAN	GMP
BM4_TGACAGAGAATN	lateEry
BM4_TGACAGGATCGG	T
BM4_TGACAGGCGTAC	lateEry
BM4_TGACCAAGGCTG	cDC
BM4_TGACCATTGTTC	T
BM4_TGACCCACGTCG	Prog
BM4_TGACCCTAAATG	CTL
BM4_TGACCGGCTGAG	Mono
BM4_TGACCTACTAGG	Prog
BM4_TGACCTCATAGT	ProB
BM4_TGACGAACCGTT	NK
BM4_TGACGACACCCT	T
BM4_TGACGCGGTCTG	earlyEry
BM4_TGACGTTTGGCT	T
BM4_TGACTCCGGTTT	ProMono
BM4_TGACTTACGGTT	Mono
BM4_TGACTTGCGTTN	ProB
BM4_TGAGATTTAGGA	ProMono
BM4_TGAGCACGGAAT	NK
BM4_TGAGCAGACGAN	ProMono
BM4_TGAGCAGAGAAT	lateEry
BM4_TGAGCCATTCAT	Prog
BM4_TGAGCTTAATGA	ProMono
BM4_TGAGGATAAAGG	ProMono
BM4_TGAGGATATGCC	earlyEry
BM4_TGAGGCGTCTGT	Prog
BM4_TGAGGGAAGCGN	Prog
BM4_TGAGGGCAGTAN	Mono
BM4_TGAGGGGGATCT	GMP
BM4_TGAGGTGGCAAG	T
BM4_TGAGTAACGGCT	GMP
BM4_TGAGTCAAAACA	earlyEry
BM4_TGAGTCGCCGAC	earlyEry
BM4_TGAGTCGTGTCC	GMP
BM4_TGAGTCTCAGCC	ProMono
BM4_TGAGTGCAGGGT	earlyEry
BM4_TGAGTGGATAGA	Prog
BM4_TGAGTTACGTGG	Mono
BM4_TGAGTTTCTTGT	GMP
BM4_TGATAAGCAGTT	T
BM4_TGATACTCATGT	NK
BM4_TGATAGTAGCTN	cDC
BM4_TGATATGACCAA	Prog
BM4_TGATCACCAGTN	cDC
BM4_TGATCGCGCTCC	T
BM4_TGATGAACCCAN	lateEry
BM4_TGATGACGACGC	Prog
BM4_TGATGGAAGAGN	Plasma
BM4_TGATGGACTTCG	CTL
BM4_TGATGGGCCTAG	Mono
BM4_TGATGGTGCGCN	cDC
BM4_TGATTACCTCGA	T
BM4_TGATTAGGATCG	CTL
BM4_TGATTAGGATTA	Prog
BM4_TGATTCAGCACC	B
BM4_TGATTCGGCCCN	Prog
BM4_TGATTGTGAGAA	T
BM4_TGATTTCATCCT	Prog
BM4_TGCAAAAATGCN	Mono
BM4_TGCAAGGCTTTN	Prog
BM4_TGCAATTAGTCN	ProMono
BM4_TGCACAGGGCAN	ProMono
BM4_TGCACAGTCGCA	pDC
BM4_TGCACGCGTATN	CTL
BM4_TGCACGGGATAG	GMP
BM4_TGCACTCTCGAT	pDC
BM4_TGCAGAAAAGTA	Mono
BM4_TGCAGACCCTAA	Prog
BM4_TGCAGATGATGA	T
BM4_TGCAGGAAGAGG	cDC
BM4_TGCAGTCCTCTG	GMP
BM4_TGCATAACGTAT	lateEry
BM4_TGCATATTCCGC	earlyEry
BM4_TGCATCGGGGCA	earlyEry
BM4_TGCATGACTGGA	ProMono
BM4_TGCATGTAATGN	T
BM4_TGCCATTAATCA	CTL
BM4_TGCCCCGCGTTN	NK
BM4_TGCCGGATTGTN	cDC
BM4_TGCCTAGCGCCT	Prog
BM4_TGCCTCAAGGGA	Prog
BM4_TGCCTCAATGGC	earlyEry
BM4_TGCCTGTTACAC	NK
BM4_TGCCTTAAGAAT	CTL
BM4_TGCGAACCCACA	cDC
BM4_TGCGACAGACTT	NK
BM4_TGCGAGTATGGA	earlyEry
BM4_TGCGATAGATTN	T
BM4_TGCGCACAAGTT	Prog
BM4_TGCGCAGATGGN	cDC
BM4_TGCGCAGTCGAA	ProMono
BM4_TGCGCCTAATGG	Prog
BM4_TGCGCTTCACTG	ProMono
BM4_TGCGGCGCCCCG	cDC
BM4_TGCGTCAAGGAT	lateEry
BM4_TGCGTGCGGGGN	lateEry
BM4_TGCGTGGAGGAG	earlyEry
BM4_TGCGTGTCCATT	GMP
BM4_TGCTAATTTTCG	ProMono
BM4_TGCTCACCGTGG	GMP
BM4_TGCTGAAGCGCA	CTL
BM4_TGCTGTATAAAC	ProMono
BM4_TGCTGTGGTTAG	GMP
BM4_TGCTTACGACTC	Mono
BM4_TGCTTCCATGTG	Prog
BM4_TGCTTCTAGTCN	NK
BM4_TGCTTCTCGGTT	NK
BM4_TGGAACGAAGCT	Prog
BM4_TGGACCGCTATA	Mono
BM4_TGGAGTCGCTTN	NK
BM4_TGGAGTGACTCC	earlyEry
BM4_TGGATATATACT	T
BM4_TGGATCGCAGAC	T
BM4_TGGATCTAGAGA	lateEry
BM4_TGGATGGTTCTN	GMP
BM4_TGGCAAGCGCGT	Plasma
BM4_TGGCACACGAGT	B
BM4_TGGCAGTAAAGG	Prog
BM4_TGGCAGTACCAT	Prog
BM4_TGGCAGTTTCTC	ProMono
BM4_TGGCATGAGTTN	Prog
BM4_TGGCATTTCGTC	ProMono
BM4_TGGCCCACCTTT	earlyEry
BM4_TGGCCCAGCGAA	Prog
BM4_TGGCCCCAGCAA	earlyEry
BM4_TGGCCGACGCCG	Mono
BM4_TGGCCGATGGCN	Mono
BM4_TGGCCTCATCAT	ProMono
BM4_TGGCGCACCGGN	cDC
BM4_TGGCGCATAGAN	T
BM4_TGGCGCATGATN	T
BM4_TGGCGGTTTATA	Prog
BM4_TGGCGTTCTCCC	earlyEry
BM4_TGGCGTTTGGAA	ProMono
BM4_TGGCTCAAAGTC	GMP
BM4_TGGCTGATAGAN	Mono
BM4_TGGCTTATAAAT	earlyEry
BM4_TGGCTTCTGTGA	T
BM4_TGGGAAAGACGN	T
BM4_TGGGATATTTGN	cDC
BM4_TGGGATTCTGGA	CTL
BM4_TGGGCAATCTCN	T
BM4_TGGGCAGTCGAN	ProMono
BM4_TGGGCAGTTGGT	earlyEry
BM4_TGGGCCGAATAN	lateEry
BM4_TGGGCGGTCACN	earlyEry
BM4_TGGGCTGCCTGN	cDC
BM4_TGGGCTTCACCC	T
BM4_TGGGGGCCATAT	ProMono
BM4_TGGGGTGATGCT	Prog
BM4_TGGGTAAGCATC	Mono
BM4_TGGGTCAACGGN	Mono
BM4_TGGGTCCACAGC	B
BM4_TGGGTCGTCATA	T
BM4_TGGTAAATGCGA	earlyEry
BM4_TGGTAGCCGCAA	Mono
BM4_TGGTAGGCCCAT	GMP
BM4_TGGTAGTCCCGN	Prog
BM4_TGGTCCAGGTGN	earlyEry
BM4_TGGTCCGATGAN	ProMono
BM4_TGGTCCGATGTA	ProMono
BM4_TGGTCGGGAAGN	Prog
BM4_TGGTGCAAGGTG	CTL
BM4_TGGTGCGTCACG	earlyEry
BM4_TGGTTAATCGGT	CTL
BM4_TGGTTAGATCCT	earlyEry
BM4_TGGTTAGTCTTN	Mono
BM4_TGGTTCTTGAGT	T
BM4_TGGTTGTTTGTN	T
BM4_TGGTTTCGTCCG	T
BM4_TGGTTTCTAGGA	Prog
BM4_TGTAACCAGTAT	Mono
BM4_TGTAAGAAAAGT	pDC
BM4_TGTACATCATAT	Mono
BM4_TGTACCGGCCTG	T
BM4_TGTAGAAGGTTG	T
BM4_TGTAGCCCGCTT	ProB
BM4_TGTAGCTTACCT	cDC
BM4_TGTAGGACCAAG	earlyEry
BM4_TGTAGGTTAAGC	CTL
BM4_TGTATACCCCAN	B
BM4_TGTATCATGGAG	T
BM4_TGTATTAAGATG	NK
BM4_TGTCACAAGTTT	ProMono
BM4_TGTCAGATTAAG	CTL
BM4_TGTCAGCTGACG	Mono
BM4_TGTCAGGCGGAG	GMP
BM4_TGTCAGTTTTGA	T
BM4_TGTCATTGGTTT	earlyEry
BM4_TGTCCACACCTN	earlyEry
BM4_TGTCCCTCATGG	T
BM4_TGTCCCTGCAGA	earlyEry
BM4_TGTCCGCACGTT	T
BM4_TGTCCGTTGCTN	ProMono
BM4_TGTCGCCAGGCG	Prog
BM4_TGTCGCCCGACG	T
BM4_TGTCGCCGCTTN	lateEry
BM4_TGTCGGATTCAG	cDC
BM4_TGTCGTGATCGA	Mono
BM4_TGTCGTGGAGTG	cDC
BM4_TGTCTCGCTATT	lateEry
BM4_TGTCTTGTGGGG	lateEry
BM4_TGTGAAAGCGTC	earlyEry
BM4_TGTGACTGGCGC	Prog
BM4_TGTGAGAGATGA	T
BM4_TGTGAGGATGTT	ProMono
BM4_TGTGATACTATC	GMP
BM4_TGTGCGTAACAN	pDC
BM4_TGTGGATTGCGA	ProMono
BM4_TGTGGCAGCCGG	T
BM4_TGTGGCGAGTTN	CTL
BM4_TGTGGGAGACCC	ProMono
BM4_TGTGGTCACGTA	GMP
BM4_TGTGGTGAGTAN	earlyEry
BM4_TGTGGTGGACCG	ProMono
BM4_TGTGTAGCTTCC	NK
BM4_TGTGTCTAGCGC	Mono
BM4_TGTGTCTCCGGT	Prog
BM4_TGTGTTATTTGG	B
BM4_TGTGTTGTTTTN	ProMono
BM4_TGTTAAGCTATG	NK
BM4_TGTTAATTCTGA	ProMono
BM4_TGTTACGGACTG	earlyEry
BM4_TGTTACGTCACC	T
BM4_TGTTACTACGTA	GMP
BM4_TGTTAGGTAACN	ProB
BM4_TGTTCAGGAGCN	ProMono
BM4_TGTTCCCCAAGA	Prog
BM4_TGTTCGAAATGT	earlyEry
BM4_TGTTCGACTTGN	CTL
BM4_TGTTCGTTAGAG	ProB
BM4_TGTTGACGCTCA	lateEry
BM4_TGTTGACGGGTT	GMP
BM4_TGTTGATGAACC	ProMono
BM4_TGTTGATTTTGN	Prog
BM4_TGTTGCGCTTCC	GMP
BM4_TGTTGGCCGGAG	T
BM4_TGTTGGGAACCT	T
BM4_TGTTGTTAACCN	ProMono
BM4_TGTTGTTTGGAG	T
BM4_TGTTTAATGGAN	earlyEry
BM4_TGTTTACATGCG	cDC
BM4_TGTTTACATGGT	T
BM4_TGTTTAGGAAGG	ProMono
BM4_TGTTTCACGATN	CTL
BM4_TGTTTCAGGAGC	ProMono
BM4_TGTTTCCCCGAG	ProMono
BM4_TGTTTCCTTCGT	NK
BM4_TGTTTCGAAGTA	Mono
BM4_TGTTTCTATGAG	B
BM4_TGTTTCTCGGTN	Mono
BM4_TGTTTGAAGGCT	NK
BM4_TGTTTTAATTCC	GMP
BM4_TGTTTTGGTTTC	ProMono
BM4_TGTTTTGTTAGN	T
BM4_TTAAAAGAGGCN	NK
BM4_TTAAACCAAACT	ProMono
BM4_TTAAAGCCTAGC	ProMono
BM4_TTAAAGGTTAAG	ProMono
BM4_TTAAATTGGGCA	Mono
BM4_TTAACCAGACAN	cDC
BM4_TTAACCGGATGC	cDC
BM4_TTAACGGATGTN	earlyEry
BM4_TTAAGACAATTN	CTL
BM4_TTAAGAGTTTGA	Prog
BM4_TTAAGCTGTACC	Mono
BM4_TTAAGGCTCACT	T
BM4_TTAAGGGCACCT	GMP
BM4_TTAAGGTTTCGN	ProMono
BM4_TTAATATAGTAG	T
BM4_TTAATGAATTTA	CTL
BM4_TTAATTGAAGAC	ProMono
BM4_TTAATTGGACTC	cDC
BM4_TTAATTTTATGT	ProMono
BM4_TTACAGTCCTAN	lateEry
BM4_TTACCATAAAAG	Plasma
BM4_TTACCCGCGGTC	earlyEry
BM4_TTACCCGTCCAG	T
BM4_TTACCTAACATN	ProMono
BM4_TTACCTTTTTCC	CTL
BM4_TTACGAGAGCGA	Prog
BM4_TTACTAAAATCA	CTL
BM4_TTACTATCTAGG	cDC
BM4_TTACTCGCGTCN	lateEry
BM4_TTACTGGTTTGT	T
BM4_TTACTGTTGTGA	T
BM4_TTAGAAGTCCTT	earlyEry
BM4_TTAGCCAACATN	ProMono
BM4_TTAGCCGCAGAC	pDC
BM4_TTAGCCTAACAT	ProMono
BM4_TTAGCGCTTCAC	Prog
BM4_TTAGCGGTTCTT	ProMono
BM4_TTAGCGTTAACN	Mono
BM4_TTAGGTTTCGCG	earlyEry
BM4_TTAGTATAAACA	GMP
BM4_TTAGTCAGAGCT	T
BM4_TTAGTCCTGGGA	cDC
BM4_TTAGTCTGGTGT	B
BM4_TTAGTTTAAATT	ProMono
BM4_TTATAAAAATAG	cDC
BM4_TTATAAGAGGCC	earlyEry
BM4_TTATAGAGCGAT	Mono
BM4_TTATAGCACCGN	Prog
BM4_TTATATCTCTTG	GMP
BM4_TTATCAGCCCAN	CTL
BM4_TTATCGAGGTCA	NK
BM4_TTATGCCATACN	GMP
BM4_TTATGCGGAAGA	earlyEry
BM4_TTATGCTCTTAN	CTL
BM4_TTATGGAAGGAG	B
BM4_TTATGTCAGAAN	T
BM4_TTATGTCCGAGN	cDC
BM4_TTATTCGATTCG	CTL
BM4_TTCAAACTCCAG	Mono
BM4_TTCAACTCTTGN	Prog
BM4_TTCAAGCGAGTA	GMP
BM4_TTCACCAAATTN	Prog
BM4_TTCACTCGTTAN	Prog
BM4_TTCAGAGGAGGN	ProMono
BM4_TTCAGCTGAAAC	earlyEry
BM4_TTCAGGCTTCCA	Prog
BM4_TTCAGGGTTGAA	T
BM4_TTCATGAACGGC	cDC
BM4_TTCATTGGATTN	B
BM4_TTCCAATATAGG	B
BM4_TTCCACTCTAAA	Prog
BM4_TTCCAGAAGGGA	cDC
BM4_TTCCCCCTCGCA	lateEry
BM4_TTCCCCCTTAGN	earlyEry
BM4_TTCCGCTAACAC	CTL
BM4_TTCCGTTTTCGA	Mono
BM4_TTCCTAAACGCG	ProB
BM4_TTCCTCTATGCN	T
BM4_TTCCTTGCCCGG	lateEry
BM4_TTCGAAGCCTAC	cDC
BM4_TTCGAAGGGGTC	GMP
BM4_TTCGAGACCTCA	T
BM4_TTCGAGTTCGTT	ProMono
BM4_TTCGCATGAATT	T
BM4_TTCGCCTGGGAC	lateEry
BM4_TTCGCGGCGTCN	ProMono
BM4_TTCGCTGGCGTC	ProMono
BM4_TTCGGACCTGAG	lateEry
BM4_TTCGGCAACCAC	T
BM4_TTCGGCAGCAAT	ProMono
BM4_TTCGGCTCACTN	T
BM4_TTCGGGTAATAG	CTL
BM4_TTCGTACTGCGG	Mono
BM4_TTCGTCACGGAT	GMP
BM4_TTCGTCAGCGGN	earlyEry
BM4_TTCGTCATTGGC	Mono
BM4_TTCGTCTCTCAN	ProMono
BM4_TTCGTGAGGTCN	Mono
BM4_TTCGTGCGTCCA	B
BM4_TTCGTGGATACN	Plasma
BM4_TTCTAAGTCGGT	Mono
BM4_TTCTAGTAGATA	ProMono
BM4_TTCTATTATTGN	NK
BM4_TTCTCCCAACAN	T
BM4_TTCTGCCCTCTG	ProMono
BM4_TTCTGCTTGCCT	NK
BM4_TTCTGGATAGGN	Prog
BM4_TTCTGTGCGGCT	GMP
BM4_TTCTGTTCTGCG	ProMono
BM4_TTGAAACGTTAA	cDC
BM4_TTGAACCGACCN	Mono
BM4_TTGAACTGCCTC	ProB
BM4_TTGAAGGCGTAG	CTL
BM4_TTGAATCGCCCA	Prog
BM4_TTGAATTTTCGC	ProMono
BM4_TTGACCTTTTAC	NK
BM4_TTGACGGTTCGN	CTL
BM4_TTGAGACATCAG	ProMono
BM4_TTGAGACTGCAT	ProB
BM4_TTGAGCCAGACN	pDC
BM4_TTGAGCTGCTTT	NK
BM4_TTGAGGAATAGN	T
BM4_TTGAGTGCGTCC	Plasma
BM4_TTGATCGTTACG	T
BM4_TTGCAAGCCCGN	Mono
BM4_TTGCAGTAAGGA	CTL
BM4_TTGCATACACGC	Prog
BM4_TTGCCCCACTTA	earlyEry
BM4_TTGCCCTGTCCN	earlyEry
BM4_TTGCCGGATCGA	Prog
BM4_TTGCGACCGACC	ProMono
BM4_TTGCGACGGAAT	ProMono
BM4_TTGCGCAGTGCC	Prog
BM4_TTGCTAATCGTN	Prog
BM4_TTGCTGATGCCA	Prog
BM4_TTGGAAAATGTG	ProB
BM4_TTGGAAATAGCC	CTL
BM4_TTGGAGGAAAAG	GMP
BM4_TTGGCAGTGCGN	Prog
BM4_TTGGCGTAATGN	earlyEry
BM4_TTGGCGTTGACA	Mono
BM4_TTGGCTAAGAAT	CTL
BM4_TTGGCTACCCCN	GMP
BM4_TTGGGATAATCN	CTL
BM4_TTGGGTTATAAT	Mono
BM4_TTGGTACGTTTC	CTL
BM4_TTGGTAGATCCG	ProMono
BM4_TTGGTCAGTGCG	pDC
BM4_TTGGTCGTATAG	GMP
BM4_TTGGTGGATGGA	Mono
BM4_TTGGTGGGCAGT	GMP
BM4_TTGGTGTTGACT	GMP
BM4_TTGTAAAACTTA	Mono
BM4_TTGTAGTTAGGN	Prog
BM4_TTGTATTGAAAT	Mono
BM4_TTGTCAGTTGAG	GMP
BM4_TTGTCGCTTGGN	lateEry
BM4_TTGTGACCAGGG	lateEry
BM4_TTGTGCCACCAG	GMP
BM4_TTGTGTCGCCTG	Prog
BM4_TTGTTACTGCCT	ProMono
BM4_TTGTTAGTCGGN	GMP
BM4_TTGTTATCAGCC	CTL
BM4_TTGTTGGCGGAN	earlyEry
BM4_TTGTTTAACTCT	Mono
BM4_TTGTTTCAAGGG	NK
BM4_TTTAACTGAGCN	lateEry
BM4_TTTAAGGTTGCC	earlyEry
BM4_TTTAATTGTGCN	CTL
BM4_TTTACCCTCTGG	GMP
BM4_TTTACGACGTTN	CTL
BM4_TTTAGAGTGGTG	Prog
BM4_TTTAGCCGATGT	ProMono
BM4_TTTAGCCGCTGT	Prog
BM4_TTTAGCGCGAGA	B
BM4_TTTATCTGTTTG	T
BM4_TTTATGACGTGA	ProB
BM4_TTTATTTTTAAN	cDC
BM4_TTTCAGCGTAAT	T
BM4_TTTCAGCTGCAG	pDC
BM4_TTTCCCCCGCAA	HSC
BM4_TTTCCGCAGTCA	T
BM4_TTTCCGCGCCGA	lateEry
BM4_TTTCCTAATTTG	Prog
BM4_TTTCCTCTGGAG	T
BM4_TTTCGAAGACAA	NK
BM4_TTTCGCGAAGTT	ProMono
BM4_TTTCGGGTCAGT	earlyEry
BM4_TTTCTAAGATAA	Mono
BM4_TTTCTGTCTTCT	GMP
BM4_TTTCTTAGTGTA	earlyEry
BM4_TTTCTTCCAGGN	GMP
BM4_TTTCTTGATGGN	T
BM4_TTTGAACTGCGC	T
BM4_TTTGACGCACAC	ProMono
BM4_TTTGAGCAAATA	ProMono
BM4_TTTGAGCATGCA	GMP
BM4_TTTGATCTGTAN	lateEry
BM4_TTTGATGTAAGN	Prog
BM4_TTTGCACCTCCC	T
BM4_TTTGCACTCCAN	Mono
BM4_TTTGCCCCGAGC	T
BM4_TTTGCGACTGTN	cDC
BM4_TTTGGTCAACTA	Mono
BM4_TTTGTCCAGTCG	Mono
BM4_TTTGTCCTGCTG	CTL
BM4_TTTGTCGATTGN	T
BM4_TTTGTCGCAGTT	T
BM4_TTTGTCTATTTG	ProMono
BM4_TTTGTCTTGGGA	T
BM4_TTTGTGGAAGTC	T
BM4_TTTGTTCGCGCA	GMP
BM4_TTTTACGCCTTG	Mono
BM4_TTTTAGAGGTGC	GMP
BM4_TTTTATCTTTGG	T
BM4_TTTTCACAACAN	NK
BM4_TTTTCCCCACTA	Prog
BM4_TTTTCTCTGGAN	GMP
BM4_TTTTCTGGATTN	T
BM4_TTTTCTTAGTCC	Mono
BM4_TTTTGACGTGAT	T
BM4_TTTTGCATCTAN	NK
BM4_TTTTGCTACGTG	Prog
BM4_TTTTGCTGGTTT	CTL
BM4_TTTTGGCAATGG	B
BM4_TTTTGTCCATTN	Mono
BM4_TTTTGTCCCCGN	T
BM4_TTTTGTTAGTGC	Prog
BM4_TTTTGTTGTAGC	Mono
BM4_TTTTTAAACTAG	GMP
BM4_TTTTTAGTTGAG	GMP
BM4_TTTTTATCACGG	Plasma
BM4_TTTTTATTATGN	ProMono
BM4_TTTTTGGATGTN	earlyEry
BM4_TTTTTTATTATG	ProMono
BM1_AAAGTCTCAAAC	cDC
BM1_AAATTTCCATTG	GMP
BM1_AAGGTTCCATAA	T
BM1_ACACCGATAATG	ProB
BM1_ACACGTGCGCAA	Mono
BM1_ACCATGCTTAAN	Mono
BM1_ACGCCAATGCTN	Mono
BM1_ACGCCTCTCAAN	GMP
BM1_ACGCTCTGGCCN	Prog
BM1_ACGTTTGAAGTG	Mono
BM1_ACTCATATAATG	ProB
BM1_ACTCGGAGGCGN	ProB
BM1_ACTTGAGGCAAG	Mono
BM1_AGAATTGTCCCG	pDC
BM1_AGAGTTATACCG	ProB
BM1_AGCGATGGTAGN	CTL
BM1_AGGAGCGGTTGG	Mono
BM1_AGGCGGGCGTGN	HSC
BM1_AGGTTTTACTGT	GMP
BM1_AGTCCCAGGCGN	ProMono
BM1_AGTGGCAGGAGC	ProB
BM1_AGTGTGAAAATT	lateEry
BM1_AGTTGAGAGGAN	Mono
BM1_ATAAACTGACTG	T
BM1_ATAACATTTCAC	HSC
BM1_ATAAGTCCCATN	lateEry
BM1_ATACTACTTCCN	CTL
BM1_ATGCCGATGCGG	ProMono
BM1_ATGTTTTCATTA	T
BM1_CAACACGAGCGA	ProMono
BM1_CAGGTCGGCCCN	ProB
BM1_CAGGTTGTTAAG	ProB
BM1_CCGAGGATGTGN	T
BM1_CCGCCTCTGGAG	pDC
BM1_CCGCTCGGTATN	lateEry
BM1_CCGCTCTGGTAT	lateEry
BM1_CCTCGGAGATTC	ProMono
BM1_CCTGACATACAN	ProMono
BM1_CGCATGGACAGT	Mono
BM1_CGCCCGATCTAT	Mono
BM1_CGCGAGAAGGGA	Mono
BM1_CGCTCCGGAAGN	lateEry
BM1_CGCTGCCCTCAT	ProMono
BM1_CGGTTGTTGTGN	Mono
BM1_CGTCAGATAATC	ProB
BM1_CGTGTTACTATN	Mono
BM1_CTACAACTTTGA	Plasma
BM1_CTACTAGCGTAG	Plasma
BM1_CTAGCATCTTTC	CTL
BM1_CTAGTTGTTCAT	pDC
BM1_CTCGAGGATACN	lateEry
BM1_CTTCATTATAGT	cDC
BM1_GAAGCTGGATGN	Mono
BM1_GAAGGACAGTTT	ProB
BM1_GACAGTCGCTTA	ProMono
BM1_GACCATACGAGA	ProMono
BM1_GAGCAATCGCAG	ProMono
BM1_GCCACGATACGA	ProB
BM1_GCCCCACTCGGT	lateEry
BM1_GCCCTATATGAT	Mono
BM1_GCCGACGCACCT	T
BM1_GCGGGATGAGTC	GMP
BM1_GCGTAGCAACGN	Mono
BM1_GCGTTAGGCACA	Mono
BM1_GGACCTTCAATN	lateEry
BM1_GGACCTTTCAAT	lateEry
BM1_GGAGTAAGGCCA	ProMono
BM1_GGATTGAATTGT	CTL
BM1_GGCACCCTGGAN	ProB
BM1_GGCGCAACTCTT	lateEry
BM1_GGGCAGGGCACN	earlyEry
BM1_GGGCCACTCCGN	Mono
BM1_GGTAGGAAAATN	T
BM1_GGTATTGCGCTT	lateEry
BM1_GGTCAACGGCTN	lateEry
BM1_GGTCACTCGGTT	CTL
BM1_GTAACCGGCTAC	GMP
BM1_GTAATAATCTCN	T
BM1_GTAGGTATAGTG	Plasma
BM1_GTCTGCTCGCTA	Mono
BM1_GTGGCGTCTCAT	ProB
BM1_GTTTCTACGGAT	Mono
BM1_TAAACTGCTCGN	pDC
BM1_TAAAGTCTCTTA	lateEry
BM1_TACACAAGCTGN	lateEry
BM1_TACCCTTCGTTN	ProMono
BM1_TAGGAGGCATAT	Plasma
BM1_TATGTAGTTCGG	Mono
BM1_TCTATTTGGACC	Mono
BM1_TCTCCATCATCN	GMP
BM1_TCTCTTAACCGA	ProMono
BM1_TGAGGCATCACN	Mono
BM1_TGATGGTCTTCT	T
BM1_TGCCCGTGCATA	ProMono
BM1_TGCGACATGAAC	cDC
BM1_TGGGTGTTCCAT	T
BM1_TGTAGAGATTTG	lateEry
BM1_TGTATTGCTTTG	earlyEry
BM1_TGTCGTATGGAT	earlyEry
BM1_TGTGCGCTGGGC	GMP
BM1_TTAGCGACTTCG	lateEry
BM1_TTAGTGGAATGT	ProB
BM1_TTCTGATGTCCG	Mono
BM1_TTGCACAGAGGA	Prog
BM1_TTTAGGCATCGN	lateEry
BM1_TTTAGTAACAGA	T
BM1_TTTGCGTTCAAT	Mono
BM1_TTTTTATTAACA	ProB
BM2_AAAATGTAGTAN	ProB
BM2_AAACCCATGGCG	ProMono
BM2_AAAGTAACAGGC	Mono
BM2_AACCTTTGTGAG	Mono
BM2_AACGATTGGAGG	Plasma
BM2_AACGTACGTTGN	lateEry
BM2_AATAAACTGAAN	Mono
BM2_AATAAGTGAGTA	lateEry
BM2_AATACCTGTTGA	ProB
BM2_AATAGTGATTGG	B
BM2_AATGTTGGGCCC	Prog
BM2_AATTTGTCAGCA	Mono
BM2_ACACGGATTGCG	Mono
BM2_ACAGTTCTGTAN	GMP
BM2_ACCAATGTCAAC	Plasma
BM2_ACCACATGCCTC	T
BM2_ACCCAGCTAGTT	Prog
BM2_ACCTTCCTATGT	ProMono
BM2_ACGCCTACGTAT	ProMono
BM2_ACGGTCCCGATT	ProB
BM2_ACGTCTCTGAAN	Mono
BM2_ACTACCTCGTCG	T
BM2_ACTCGATTGTGG	Mono
BM2_ACTCGCGTATGN	GMP
BM2_ACTCTAAGACAA	lateEry
BM2_ACTCTTCCAAAG	Prog
BM2_ACTTGAATCGTC	Mono
BM2_AGAAGAGTGTGG	pDC
BM2_AGAAGTCAGGTT	pDC
BM2_AGAGACCATGGG	lateEry
BM2_AGCAATCGTCCG	ProMono
BM2_AGCAGATCAATG	T
BM2_AGCCAATTGCGA	Mono
BM2_AGCGCGGCGTCN	lateEry
BM2_AGCGGCTACTGT	lateEry
BM2_AGCTACGATTTG	ProMono
BM2_AGGCACACAGCN	T
BM2_AGTAAGTGTAGN	ProB
BM2_AGTGTCTTTTTN	Mono
BM2_AGTTTGAGGGGN	lateEry
BM2_ATAAAATATGAG	Mono
BM2_ATAAAGCCTGAN	pDC
BM2_ATACGTATGAAT	ProB
BM2_ATAGCTGTAATN	lateEry
BM2_ATAGCTGTTAAT	earlyEry
BM2_ATCAGCTAGGAN	Plasma
BM2_ATCTTCTAACCA	Mono
BM2_ATGGTGTCTGGA	lateEry
BM2_ATGGTTAACGCN	T
BM2_ATTGAGTTTTGC	lateEry
BM2_ATTGTGCTTTCA	T
BM2_CAAGAACGCACN	Mono
BM2_CAAGTGTCCTAT	Mono
BM2_CACAGGCATAGN	ProMono
BM2_CACCCATGTCAC	Mono
BM2_CAGGTAAAGTTG	ProMono
BM2_CATCAGGTATAG	Mono
BM2_CATGTCAGCGTC	ProB
BM2_CCATCCGAGAAN	Mono
BM2_CCCACATTCGGT	Mono
BM2_CCCCGCGCTGGT	T
BM2_CCCGGACCTGGN	CTL
BM2_CCCGTCCCTGCC	Mono
BM2_CCCGTGATAGAA	ProMono
BM2_CCCTAGTCCATN	HSC
BM2_CCGTCATCATAG	lateEry
BM2_CCTGCCTTATTG	ProB
BM2_CGAATGCGGTGA	Mono
BM2_CGAGACGTGGAA	GMP
BM2_CGAGCAAGCGAN	ProMono
BM2_CGAGTGTTTAAG	Mono
BM2_CGCCGCTTTATA	Mono
BM2_CGCCTAAAACTT	cDC
BM2_CGCGTCGCGTTT	Prog
BM2_CGGAGACAACTG	earlyEry
BM2_CGGAGGCTGGAN	T
BM2_CGGATTCACCGT	Prog
BM2_CGGCCCCGTCCA	HSC
BM2_CGGCGGATCAGN	cDC
BM2_CGGTAGTGTGGT	GMP
BM2_CGGTGAGCATCC	HSC
BM2_CGTTCACTTGAC	B
BM2_CGTTTTGGGAGC	Mono
BM2_CTAACGCACCTA	ProB
BM2_CTAATTATGTGG	Mono
BM2_CTACACTTAACG	Mono
BM2_CTACGTTTCGCT	earlyEry
BM2_CTCACCCGAGGN	Mono
BM2_CTCAGGTATTGT	Mono
BM2_CTCAGTTATGAA	Mono
BM2_CTGATTACGCAA	ProMono
BM2_CTGGAGACATCT	ProMono
BM2_CTGGTTGTGTAT	earlyEry
BM2_GAAAGGATTCAN	Mono
BM2_GAAGAGTACGCT	lateEry
BM2_GAATCGGTATCN	Mono
BM2_GACCAAATAGTT	Prog
BM2_GACTTTTGTCCN	ProB
BM2_GAGAGCGAGGAG	Mono
BM2_GAGATAACACGT	ProMono
BM2_GAGGGCTTGGGA	lateEry
BM2_GATACGGGCTTC	earlyEry
BM2_GATATCAATCAN	cDC
BM2_GATTGTCGCCAN	pDC
BM2_GATTTGAGTAGN	Mono
BM2_GCAATCCAACGT	Mono
BM2_GCAGGCCATCGA	T
BM2_GCATGAATGTAN	cDC
BM2_GCGAGTATCGTT	ProMono
BM2_GCGCCCCAACCG	lateEry
BM2_GCGGTATTGAAG	Mono
BM2_GCTAGATTCTGC	Mono
BM2_GCTCAACGCTGG	lateEry
BM2_GCTTAACCCGTN	Mono
BM2_GCTTAACTCCGT	Mono
BM2_GCTTATAATTGT	lateEry
BM2_GGAATTCTACAG	pDC
BM2_GGAGCTGCGTGA	cDC
BM2_GGAGTCTAGTAG	Mono
BM2_GGATCATCTATC	GMP
BM2_GGATGCAATGCA	Mono
BM2_GGCACTCTAGCT	Mono
BM2_GGCAGTGACAAT	Mono
BM2_GGCCAGGTCCCA	T
BM2_GGCGAGCATACN	cDC
BM2_GGCGCTCCGTCA	Mono
BM2_GGGCTTCCGTTA	ProMono
BM2_GGTGAGTGGTAC	Mono
BM2_GGTGCCACAGGA	Mono
BM2_GGTTTGCGTTAC	Plasma
BM2_GTAGCTGATGCG	HSC
BM2_GTAGGTTGCCGG	ProMono
BM2_GTAGTCAGTCGA	Mono
BM2_GTATAGCTATCG	Mono
BM2_GTCCCATTCTGN	ProMono
BM2_GTGATGAGGAGA	ProB
BM2_GTTCGGATCGGA	Mono
BM2_GTTGACGGGTCG	ProMono
BM2_GTTGGCGTAGCT	T
BM2_GTTTCAGAGATN	ProMono
BM2_GTTTTGTCCAAN	T
BM2_TAACCAATACCG	GMP
BM2_TACATCAGAGGG	Prog
BM2_TAGAGGCAGGCN	lateEry
BM2_TAGATTAAATGA	CTL
BM2_TAGCCAACTGCT	cDC
BM2_TAGCTCGCTTTA	Mono
BM2_TAGGGCACTCTN	cDC
BM2_TATAATGCGGAT	Plasma
BM2_TATCATCTCCGN	T
BM2_TATCCACACGCT	T
BM2_TATGACCATGTT	T
BM2_TATGCCTAGCGN	HSC
BM2_TCAACATGAATC	cDC
BM2_TCAATCCGGTGN	lateEry
BM2_TCACGGTCGGCN	Prog
BM2_TCAGCCATGGGA	cDC
BM2_TCAGGTATTGTN	Mono
BM2_TCATTACCCGCC	lateEry
BM2_TCGGTTTGGGCA	Mono
BM2_TCTAATAGATGT	Mono
BM2_TCTAGGGACGCA	Mono
BM2_TCTATAAACCCN	T
BM2_TCTGATTTAAGG	ProMono
BM2_TGAACAGGCACA	T
BM2_TGAACTCTTTTC	cDC
BM2_TGAAGATGGCCN	earlyEry
BM2_TGAAGATTGGCC	Prog
BM2_TGCACCGTTCTC	Mono
BM2_TGCAGCGGCAAC	Mono
BM2_TGCTCATGATGG	cDC
BM2_TGCTTCAGCAAG	GMP
BM2_TGGCAACAGATA	cDC
BM2_TGGCTCGCCAGC	lateEry
BM2_TGGTTCTGATTC	Mono
BM2_TGTGGTGCTAAG	Mono
BM2_TGTGTTCTACCN	lateEry
BM2_TGTTTAGCCAGC	ProMono
BM2_TTACGAGCACGA	CTL
BM2_TTAGGTGTCCCC	NK
BM2_TTATGATGAAAA	Mono
BM2_TTCCAGCCCTCT	Mono
BM2_TTCCGGTAACCN	ProMono
BM2_TTCCTACACGAN	Mono
BM2_TTCTCATGTTTG	GMP
BM2_TTCTCGACGTGG	earlyEry
BM2_TTCTGACGAACT	earlyEry
BM2_TTGCACTGGGAN	Plasma
BM3_AAAAACGTTACN	ProMono
BM3_AAAATGAAAACA	cDC
BM3_AAAGTCTTACGC	lateEry
BM3_AAATACAATGCN	T
BM3_AAATCTCAAGTN	T
BM3_AAATTCAGACTG	lateEry
BM3_AACAGCTATCAG	Prog
BM3_AACATAATATTC	earlyEry
BM3_AACATCGACTCG	pDC
BM3_AACCAATCATTT	ProMono
BM3_AACCAGAGTGCT	lateEry
BM3_AACGCAAAGTGG	lateEry
BM3_AACTCATCCTTA	Mono
BM3_AAGAGGCAGGCN	earlyEry
BM3_AAGAGGGCAGGC	earlyEry
BM3_AAGCAGGATTCT	T
BM3_AAGCGGAACAGA	T
BM3_AAGCTCTCTTGC	T
BM3_AAGGAACTTTCN	CTL
BM3_AAGGAGAGGCAN	T
BM3_AAGGCCGTATCN	Mono
BM3_AAGGCGACAGCN	ProMono
BM3_AAGGGTCGGTGC	Mono
BM3_AAGGGTTTTGAC	lateEry
BM3_AAGGTCGCGGTA	earlyEry
BM3_AAGGTCGTCCCA	T
BM3_AAGGTGCTGTGG	NK
BM3_AAGTTCACGACG	Mono
BM3_AATCCAATTGAA	pDC
BM3_AATCTTTCGTGN	cDC
BM3_AATGCACTTGTA	CTL
BM3_AATGTACAGTAT	GMP
BM3_AATGTTAATGCT	ProMono
BM3_AATTGCAAAGAT	Mono
BM3_AATTTAATTCTA	cDC
BM3_ACAAAGCTAGTC	Mono
BM3_ACAAATATGAAC	ProMono
BM3_ACAAGGAGTGAN	earlyEry
BM3_ACAATAGATGGA	earlyEry
BM3_ACAATTTCGTCA	T
BM3_ACACTTATGAGN	GMP
BM3_ACAGACTCGGAA	ProMono
BM3_ACAGCATGCTAG	HSC
BM3_ACAGGGGGCTGT	GMP
BM3_ACAGGTGAACAG	T
BM3_ACAGTGATTTCN	HSC
BM3_ACATCGTGAGAN	T
BM3_ACATTTGAGTGA	Mono
BM3_ACCAATCGGATA	CTL
BM3_ACCACGTACAAC	Mono
BM3_ACCACTTAATGA	cDC
BM3_ACCCGTGCCTCA	cDC
BM3_ACCCTGGCCACN	T
BM3_ACCGGAGCGCTT	Mono
BM3_ACCGGCAAGAAT	Mono
BM3_ACCGTACTCCGT	cDC
BM3_ACCGTTAGAAGG	Mono
BM3_ACCTGAGGTTAG	GMP
BM3_ACCTTGTTCGCG	T
BM3_ACCTTTTCCAAT	Mono
BM3_ACGACTGGCATA	cDC
BM3_ACGGTAGCATCT	CTL
BM3_ACGGTCTTCATC	earlyEry
BM3_ACTAACATCGTN	CTL
BM3_ACTAGCATCATN	T
BM3_ACTAGCGAGAGN	ProMono
BM3_ACTCAGTGTCGN	Mono
BM3_ACTCTCGCTAGT	T
BM3_ACTGACTTTGAN	Mono
BM3_ACTGGCGGACCN	earlyEry
BM3_ACTGTTGGCATA	ProMono
BM3_ACTTAGGTAGGG	Mono
BM3_ACTTGAGTGCGN	lateEry
BM3_ACTTTGAGTGCG	lateEry
BM3_AGAAGCTTAACN	CTL
BM3_AGAATCTTTTGA	earlyEry
BM3_AGAGAGATTTGT	ProMono
BM3_AGAGCGATAATG	Prog
BM3_AGAGTCTCCTCN	lateEry
BM3_AGATTTACCCCN	GMP
BM3_AGATTTCGCTTA	CTL
BM3_AGCAAACCGCTA	T
BM3_AGCAAGATCAAN	Mono
BM3_AGCAGACAGGGN	earlyEry
BM3_AGCAGAGGATCA	Mono
BM3_AGCCCGGAGCTA	Mono
BM3_AGCCGCAGTCGT	ProMono
BM3_AGCCTAGTTCCA	ProMono
BM3_AGCCTGGAGGCG	HSC
BM3_AGCCTTCGGCTG	cDC
BM3_AGCGATACAGTC	earlyEry
BM3_AGCGGCACTAAG	earlyEry
BM3_AGCGGCGCGAGG	earlyEry
BM3_AGCTAACTCCGN	Mono
BM3_AGCTATGGTTAG	earlyEry
BM3_AGCTGACCTCAN	Mono
BM3_AGCTTCGGATGG	lateEry
BM3_AGGACCAGTGTT	cDC
BM3_AGGACGCCTTGC	HSC
BM3_AGGAGTTTGTTN	T
BM3_AGGATATGCTAC	ProMono
BM3_AGGCCTAGGCTG	lateEry
BM3_AGGCTAGTATCT	NK
BM3_AGGTGCAGGTAA	lateEry
BM3_AGGTTCGACTGN	ProMono
BM3_AGTACCAGAGTN	pDC
BM3_AGTATCTATGAA	Mono
BM3_AGTCAGGTTTTC	CTL
BM3_AGTCTCCATTTG	ProMono
BM3_AGTGGTCCGGGT	Mono
BM3_AGTGTTGAATCG	cDC
BM3_AGTTAACGGGAN	earlyEry
BM3_AGTTCGCTTGGA	NK
BM3_ATAAGCTCATCA	B
BM3_ATAATTGTTAAN	CTL
BM3_ATACCTTGCGAC	Mono
BM3_ATAGAACCGTCT	Mono
BM3_ATCAGAGAATGT	T
BM3_ATCAGGTTGTCT	ProMono
BM3_ATCCACGTAAAA	ProMono
BM3_ATCCCAACAATC	T
BM3_ATCCCTCACTGN	Prog
BM3_ATCCCTTCATAN	lateEry
BM3_ATCCGGAAGCCA	ProMono
BM3_ATCCTTCCATTG	ProMono
BM3_ATCGACGGTGGA	CTL
BM3_ATCGACTTTGAC	Mono
BM3_ATCTAAGTGTGN	GMP
BM3_ATCTACCTCTCG	T
BM3_ATCTTAACAATT	Mono
BM3_ATCTTCAGACCT	earlyEry
BM3_ATGAAGTATACC	GMP
BM3_ATGACGCCTAGA	cDC
BM3_ATGACTTACGAG	cDC
BM3_ATGAGAATCTCC	earlyEry
BM3_ATGAGAGAAAGG	Mono
BM3_ATGAGGGCAATG	cDC
BM3_ATGATTGGCGCC	CTL
BM3_ATGCAGAATCAN	earlyEry
BM3_ATGCCCCAGTTN	lateEry
BM3_ATGCCGTTATAC	ProMono
BM3_ATGCTAGTCCTA	cDC
BM3_ATGGCCTAAAGG	Mono
BM3_ATGGTCATTATN	T
BM3_ATGGTTAACAGT	HSC
BM3_ATGTAAAGCCCN	CTL
BM3_ATGTCTTCCAGN	GMP
BM3_ATGTGCCAGGTT	NK
BM3_ATGTGTGGCTGA	earlyEry
BM3_ATTCAGTCGACN	T
BM3_ATTCATGGACTT	ProMono
BM3_ATTCCTGTTCAG	Mono
BM3_ATTCGTATCCAN	T
BM3_ATTCTGAAGGAT	T
BM3_ATTCTTGAGCGG	Mono
BM3_ATTGAACGGGAA	cDC
BM3_ATTGGCTGGATT	ProB
BM3_ATTGTATGCACG	CTL
BM3_ATTGTTAAATGA	lateEry
BM3_ATTGTTGACATN	ProMono
BM3_ATTTCGATGAAN	GMP
BM3_ATTTGCGTTCGA	lateEry
BM3_ATTTTGTTGGAT	lateEry
BM3_CAAAAAGAGCCN	lateEry
BM3_CAAAAAGAGCTC	lateEry
BM3_CAAAAATAGCCT	Mono
BM3_CAAAACTCGTCC	earlyEry
BM3_CAAACAGAGGGG	GMP
BM3_CAAAGGTCTCAG	lateEry
BM3_CAACCGGTGGAT	earlyEry
BM3_CAAGTTAAGCCN	Prog
BM3_CAATACCCTTTG	Mono
BM3_CAATCCGGTGTN	Mono
BM3_CACAAGCTAGTT	ProMono
BM3_CACAAGGTCTAN	T
BM3_CACATAACGGTC	GMP
BM3_CACCGCGTCTCC	ProMono
BM3_CACCTATCCGAT	lateEry
BM3_CACGATTTAGCT	ProMono
BM3_CACGCTGAAGGC	T
BM3_CACGGCCAGATA	Mono
BM3_CACTCCGAGCTG	CTL
BM3_CACTTAGAGATG	CTL
BM3_CAGAAACCTTTT	CTL
BM3_CAGAGAAGAGAN	T
BM3_CAGAGCTTAGAG	earlyEry
BM3_CAGAGGGAGTAC	ProMono
BM3_CAGCAGGCACAC	Prog
BM3_CAGGGCAGTCCC	earlyEry
BM3_CAGGGTAAAATC	cDC
BM3_CAGGTATATCTA	T
BM3_CAGGTTGCCGAC	ProMono
BM3_CAGTCCGTAGCG	earlyEry
BM3_CAGTTAGCCTGN	Mono
BM3_CAGTTCACCAGN	lateEry
BM3_CAGTTCCCGCTG	earlyEry
BM3_CATAAGTAAGGN	earlyEry
BM3_CATAGCACGTCA	lateEry
BM3_CATATATAAGCA	NK
BM3_CATCCCACGAAN	ProMono
BM3_CATGAGCGTGGN	T
BM3_CATGAGGACTAN	T
BM3_CATGGAGCGATA	NK
BM3_CATGTCATCTGA	CTL
BM3_CATTACCATTCN	cDC
BM3_CATTTCGCTAAN	ProMono
BM3_CCACCACATGTT	T
BM3_CCACCTACTCCA	T
BM3_CCAGCTTTCAGA	ProMono
BM3_CCAGTGTTAGGN	T
BM3_CCATAACGGGGN	lateEry
BM3_CCCAACCGGAGN	lateEry
BM3_CCCAGTAAGACG	lateEry
BM3_CCCAGTGCGCGT	GMP
BM3_CCCATATGCCTA	ProMono
BM3_CCCGTCCAATCN	lateEry
BM3_CCCGTGGTTCCN	cDC
BM3_CCCTTTGAGGAT	T
BM3_CCGAATATCTAA	lateEry
BM3_CCGACCACTCCT	earlyEry
BM3_CCGACCTATGGA	lateEry
BM3_CCGAGAGTTGAT	earlyEry
BM3_CCGAGCAATTGT	Prog
BM3_CCGCGTGAACGT	HSC
BM3_CCGGAGCAATCN	lateEry
BM3_CCGGGGCTCGCG	cDC
BM3_CCGGTACGCTCN	T
BM3_CCGGTTATGGCC	pDC
BM3_CCGTAGGCACAC	cDC
BM3_CCGTCTACTGAN	ProMono
BM3_CCGTTCAAGCGC	Mono
BM3_CCGTTGAGTTCN	Mono
BM3_CCGTTGCTAAGG	Prog
BM3_CCTAAGGGAGAG	earlyEry
BM3_CCTAAGTCTTAT	ProMono
BM3_CCTACCTTTGTC	T
BM3_CCTATTTTTGGN	Mono
BM3_CCTCGGTTATTG	ProMono
BM3_CCTCGTCCGCTN	GMP
BM3_CCTCTACATGGA	Mono
BM3_CCTCTTTCTGCG	Prog
BM3_CCTGTGGAATAG	T
BM3_CCTTCTAGACTT	pDC
BM3_CGAAATGTGGTN	pDC
BM3_CGAACTATTCAG	earlyEry
BM3_CGAACTTCGTTN	ProMono
BM3_CGAATACACACG	earlyEry
BM3_CGACTATAATAG	pDC
BM3_CGACTTATCGCN	cDC
BM3_CGACTTTATCGC	ProMono
BM3_CGAGATTCGGTC	cDC
BM3_CGAGTTAAGGAA	T
BM3_CGATACGGCTTN	Prog
BM3_CGATGGGAGATA	lateEry
BM3_CGCACGCAGAAC	CTL
BM3_CGCAGCAGGATN	Mono
BM3_CGCAGGTGAACG	ProMono
BM3_CGCCCGCAATGG	Mono
BM3_CGCCGGAGGACG	Prog
BM3_CGCGAGCCATCA	T
BM3_CGCGCTACCAGN	B
BM3_CGCGCTCGCACA	ProMono
BM3_CGCGTTAGTCCT	T
BM3_CGCTCGGACGGG	cDC
BM3_CGCTGAGACGCA	earlyEry
BM3_CGGAAATGGGCT	Mono
BM3_CGGACCTAGGAT	ProMono
BM3_CGGACTGTCATC	GMP
BM3_CGGAGACCGGCA	earlyEry
BM3_CGGAGCCCTTTG	cDC
BM3_CGGATGTAGGGC	B
BM3_CGGCATGTGGAC	Mono
BM3_CGGCCCTGGGGA	Mono
BM3_CGGCCTTAAATN	NK
BM3_CGGCTTTCAAGN	Mono
BM3_CGGGACCTGTTC	earlyEry
BM3_CGGTCATGAGAG	T
BM3_CGGTCATTTCTC	lateEry
BM3_CGGTCCTGTGAN	CTL
BM3_CGGTCTCACGTC	ProMono
BM3_CGGTTCTTATGC	earlyEry
BM3_CGGTTTAGTCTT	T
BM3_CGGTTTTCTAAT	ProMono
BM3_CGTAAACTTGAC	CTL
BM3_CGTAACTTCGTT	ProMono
BM3_CGTACGGATATA	T
BM3_CGTAGCCCGTTA	ProMono
BM3_CGTCCAACTGAA	CTL
BM3_CGTCCGAATGTN	ProMono
BM3_CGTCGACAGTCN	CTL
BM3_CGTCGGTTGTAG	lateEry
BM3_CGTGAGAACGTA	ProMono
BM3_CGTTCGTAACAN	cDC
BM3_CGTTGAATCGCT	ProMono
BM3_CGTTGGCTGTGN	T
BM3_CGTTGTTTCCAA	ProMono
BM3_CTAAAAGTGGTA	Plasma
BM3_CTAAACCTAGCT	CTL
BM3_CTAACTCAGTGT	cDC
BM3_CTAATTACGCTC	ProMono
BM3_CTAATTTAAGTT	T
BM3_CTACATCGGTGA	B
BM3_CTACCAGATTGG	Prog
BM3_CTACGCGCGTCT	ProMono
BM3_CTACTTTAGGAG	Plasma
BM3_CTAGTCAAGCGG	HSC
BM3_CTATTGCCAAGT	GMP
BM3_CTATTGCGTGCG	ProMono
BM3_CTCACAGAGCTN	T
BM3_CTCACAGCGAAC	CTL
BM3_CTCAGCAGCGCN	ProMono
BM3_CTCATGATTGTA	cDC
BM3_CTCTCGACATTA	Prog
BM3_CTCTGCCGCAAT	ProMono
BM3_CTGAATGTTGTT	lateEry
BM3_CTGAGAGTTAGN	earlyEry
BM3_CTGCCGCACTTG	T
BM3_CTGCCTCCGGCT	Prog
BM3_CTGCGCGCGCAT	pDC
BM3_CTGGCCGAATAC	earlyEry
BM3_CTGGCGTAAAGA	ProMono
BM3_CTGGTACCTCAG	T
BM3_CTGTAGCACCCN	cDC
BM3_CTGTTTTTAATG	ProMono
BM3_CTTACATGTCCG	ProMono
BM3_CTTACGAGGCCG	NK
BM3_CTTATACCTCAT	cDC
BM3_CTTCACCCTTCA	Prog
BM3_CTTCCCTTGGCC	earlyEry
BM3_CTTCTCAGTCAN	cDC
BM3_CTTGCCGCGCCA	GMP
BM3_CTTGTGGTTTAT	Mono
BM3_CTTTAAGTCGCG	T
BM3_CTTTATGAATCG	T
BM3_CTTTCGAGGCGN	T
BM3_GAAACCGAGCAA	earlyEry
BM3_GAAAGCTCTCTA	GMP
BM3_GAAATCTATCTT	Prog
BM3_GAAATGGTAGTT	NK
BM3_GAACAACCATCN	CTL
BM3_GAACAAGAAGGA	earlyEry
BM3_GAACATGCACGA	Mono
BM3_GAACCAACGACN	Mono
BM3_GAACCCAAGGAG	Mono
BM3_GAATATAAGTGN	Plasma
BM3_GACACAATACGG	GMP
BM3_GACACGCCTTTT	lateEry
BM3_GACAGGAATGTA	pDC
BM3_GACAGGAATTAN	pDC
BM3_GACCGGCTTCTA	T
BM3_GACGAAGTGCCT	lateEry
BM3_GACGACTTCGCA	T
BM3_GACGCACCGGCC	Mono
BM3_GAGAGGACTTAG	GMP
BM3_GAGATACAACCC	Mono
BM3_GAGATACGCCTG	GMP
BM3_GAGCATAGCCGG	T
BM3_GAGCTCTGTTCA	Prog
BM3_GAGTATCTTGGN	T
BM3_GAGTCGAGTCTN	GMP
BM3_GAGTTCTGTATC	earlyEry
BM3_GAGTTGTAGCCN	CTL
BM3_GAGTTTCTTAGN	Mono
BM3_GATACGACGGAN	earlyEry
BM3_GATACGTACGGA	earlyEry
BM3_GATACGTATGTA	Plasma
BM3_GATAGGTCCGTN	Mono
BM3_GATCGCTTAGGA	Prog
BM3_GATCTTTGTCGN	ProMono
BM3_GATTAACGCGCN	GMP
BM3_GATTCGCGGTTA	earlyEry
BM3_GATTTACGCTTG	ProMono
BM3_GATTTCGTGGAG	lateEry
BM3_GCAAAACTCTGG	HSC
BM3_GCAAAGCATGCN	cDC
BM3_GCAACATTTGCN	Mono
BM3_GCAATAGATTCC	CTL
BM3_GCACAAACTTTC	ProB
BM3_GCACATCGTGCT	GMP
BM3_GCACATCTGGTG	lateEry
BM3_GCACCATGCTGC	earlyEry
BM3_GCAGGATCACGN	T
BM3_GCATAGAAGGCN	pDC
BM3_GCATGGATCTGA	ProMono
BM3_GCATTAGAAGGC	pDC
BM3_GCATTTCAGAGA	earlyEry
BM3_GCCAAGCGAGAN	Mono
BM3_GCCAGAGTGCTN	Prog
BM3_GCCCGATCATAA	Mono
BM3_GCCCGCTGGAGC	GMP
BM3_GCCGAGCGAATT	GMP
BM3_GCCGCAACTTGC	ProMono
BM3_GCCTCCGGTGGC	ProMono
BM3_GCCTGGTGCGGA	pDC
BM3_GCGATCCACAAC	B
BM3_GCGCCAGGTATG	ProMono
BM3_GCGCCTGTAGTT	Mono
BM3_GCGCGGGATTCN	lateEry
BM3_GCGCTGGGATTC	earlyEry
BM3_GCGCTGGGTTCN	earlyEry
BM3_GCGGGCGTCATC	lateEry
BM3_GCGGTGAGACTT	Prog
BM3_GCGTATTACTGN	T
BM3_GCTCAGCAGTCN	GMP
BM3_GCTCGGGCGCAT	Prog
BM3_GCTCTCCGGAAN	B
BM3_GCTGAATTAAGN	lateEry
BM3_GCTGCGGGTGAN	ProMono
BM3_GCTGTGCTTGTT	lateEry
BM3_GCTTAATAGCCG	lateEry
BM3_GCTTCACAGTAG	Mono
BM3_GCTTGGATGTGC	Mono
BM3_GGAAGGTATTTG	GMP
BM3_GGAAGTTAGTCA	Mono
BM3_GGAATCTCCGAG	earlyEry
BM3_GGACGCGATAAC	T
BM3_GGACTGGCGTAA	pDC
BM3_GGAGCCCCGATA	GMP
BM3_GGAGGCGTGGGN	ProMono
BM3_GGAGTAGGAAGN	Prog
BM3_GGAGTAGGAATG	Prog
BM3_GGATCCAAATCA	Prog
BM3_GGATGAGTGTCT	T
BM3_GGATGTCATTGT	ProMono
BM3_GGCAAAGCAACA	HSC
BM3_GGCAGGGAAGAN	ProMono
BM3_GGCATCCCGGTN	T
BM3_GGCATTGCGCTG	CTL
BM3_GGCCCTACACCN	earlyEry
BM3_GGCCCTCTATAC	lateEry
BM3_GGCGGGCATGAN	Prog
BM3_GGCTACAGCTAT	Mono
BM3_GGCTCTAGCACT	pDC
BM3_GGCTTAAGTATN	HSC
BM3_GGCTTTTAGCCC	Prog
BM3_GGGACACCGCTC	cDC
BM3_GGGCCACAAGAC	CTL
BM3_GGGCTGAATACC	earlyEry
BM3_GGGTCGACCCCC	cDC
BM3_GGGTCTGGTCCN	cDC
BM3_GGGTTAATACGT	ProB
BM3_GGGTTCGTTCTT	lateEry
BM3_GGTCAGCTCGTT	T
BM3_GGTCATATGCAG	ProMono
BM3_GGTCGTGGTGAG	T
BM3_GGTCTAAAGGAC	T
BM3_GGTGCGTTTCAC	lateEry
BM3_GGTGTTTGACTN	CTL
BM3_GGTTGATTTTTT	ProMono
BM3_GGTTGCTGACCT	T
BM3_GTAAACGCCATC	pDC
BM3_GTAAATACTTCN	CTL
BM3_GTAACGCCGAGA	B
BM3_GTAATCTAATTA	earlyEry
BM3_GTAATTCAAGAT	T
BM3_GTACAGATAGGC	ProMono
BM3_GTACCGCACTAN	ProMono
BM3_GTAGAATGCCAN	T
BM3_GTATGTTTGGTN	cDC
BM3_GTATTCTCGACA	Mono
BM3_GTATTGGCGCCC	lateEry
BM3_GTCAAATACAGG	Plasma
BM3_GTCAAGTCCAGT	T
BM3_GTCAGGTGTCCC	NK
BM3_GTCAGTGAGCGG	cDC
BM3_GTCCGTTCGAGA	GMP
BM3_GTCGCAAAGAGT	Prog
BM3_GTCGCGTAAAAN	NK
BM3_GTCGTTTTTGCN	earlyEry
BM3_GTCTCTACGAGC	Mono
BM3_GTCTTCGAATGA	GMP
BM3_GTGAAGCGGTTN	earlyEry
BM3_GTGACGCACCTT	Mono
BM3_GTGATTAAGTTT	T
BM3_GTGCTAGAACCN	T
BM3_GTGCTCTATTGN	Mono
BM3_GTGCTTCCTGCT	B
BM3_GTGCTTGCTCCC	Mono
BM3_GTGGCCCCCTGC	cDC
BM3_GTGTAGCCCAGG	earlyEry
BM3_GTGTCAGTCTGC	lateEry
BM3_GTGTCCTCTGCG	B
BM3_GTGTGACAATCG	cDC
BM3_GTTAACTACCAG	Mono
BM3_GTTACTTCTATN	T
BM3_GTTAGAGCAGAT	earlyEry
BM3_GTTCCGAGCAGA	CTL
BM3_GTTCTCCAATGT	Mono
BM3_GTTCTGGGTCGT	GMP
BM3_GTTCTTGCTAAN	lateEry
BM3_GTTGACTACCTN	HSC
BM3_GTTTAAAGTCGN	ProMono
BM3_GTTTCGGTGGTN	earlyEry
BM3_GTTTGAACTGGN	cDC
BM3_TAAATCCATACA	T
BM3_TAAATGATTGTA	B
BM3_TAAGAGATCGAG	T
BM3_TAATCTGACGTA	CTL
BM3_TACAGAGGAAGN	earlyEry
BM3_TACAGGGTAAGC	pDC
BM3_TACAGTGCAATG	GMP
BM3_TACATGACAAAG	cDC
BM3_TACATTCCTTAN	B
BM3_TACCGAATCGGG	lateEry
BM3_TACGAAGCGCGA	GMP
BM3_TACGAGTTGGAA	GMP
BM3_TACGGAAGCGGA	earlyEry
BM3_TACGTGAGTCGN	lateEry
BM3_TAGACTAAGACG	ProMono
BM3_TAGACTATGCGT	lateEry
BM3_TAGATTAATGCA	T
BM3_TAGCAGACGATA	earlyEry
BM3_TAGCGCTCGGCN	earlyEry
BM3_TAGGCCAAACAT	Prog
BM3_TAGTCTACATAN	Mono
BM3_TAGTGCCTGACT	T
BM3_TATCCGACAGAA	T
BM3_TATCCTAGGTGC	B
BM3_TATGTCGTTGTT	Mono
BM3_TATTTCCTCGAN	lateEry
BM3_TCAAACTGAACC	Mono
BM3_TCACAGAGGAAG	earlyEry
BM3_TCACGCTTTTCA	CTL
BM3_TCAGTAGGCGAC	pDC
BM3_TCAGTGAGACGA	Mono
BM3_TCATCATGAAGG	ProMono
BM3_TCATCTAGTTTG	HSC
BM3_TCATGGAGTTAC	earlyEry
BM3_TCATGTAGCTGT	B
BM3_TCATGTTAGTTT	lateEry
BM3_TCATTACCCTTN	ProMono
BM3_TCCAGACCTCAG	Mono
BM3_TCCAGCTAGGCA	T
BM3_TCCGTATAGGTC	GMP
BM3_TCCTAGTTCTGA	CTL
BM3_TCCTCCAGAAGC	Mono
BM3_TCGAACTATATC	Mono
BM3_TCGATCGCTTTT	pDC
BM3_TCGATTGTTGCA	GMP
BM3_TCGCGCGCTTGA	earlyEry
BM3_TCGGAAGTCGAT	lateEry
BM3_TCGGCCGGATCA	earlyEry
BM3_TCGTATCTTCAN	Mono
BM3_TCGTCAGTCATG	GMP
BM3_TCGTGCGGTTTT	cDC
BM3_TCTCAAGCTGTG	earlyEry
BM3_TCTCCCGCTAAG	earlyEry
BM3_TCTGGTGTTTCN	Mono
BM3_TCTTAGCAATCA	Prog
BM3_TGAAAGAATGAG	T
BM3_TGAAAGGAGTAN	cDC
BM3_TGAAAGGGAATT	pDC
BM3_TGAACAAGTGTC	GMP
BM3_TGAAGCAGGAGT	ProMono
BM3_TGAAGCCGTTGT	T
BM3_TGAAGTAATTGN	Mono
BM3_TGACGCCGCGAA	B
BM3_TGACTTCTCGAA	Prog
BM3_TGAGCAACGGAG	GMP
BM3_TGAGGCGACATA	Prog
BM3_TGAGTGATGTAA	earlyEry
BM3_TGATGTTAGTCC	earlyEry
BM3_TGATTCAGGTGT	Mono
BM3_TGCAAACTTTTA	earlyEry
BM3_TGCACAGGTGCC	T
BM3_TGCAGGAACTAG	earlyEry
BM3_TGCAGGTGGATG	Mono
BM3_TGCATCTTGTTC	lateEry
BM3_TGCCCCGTAAAC	ProMono
BM3_TGCCCTAAGTAG	earlyEry
BM3_TGCCGGCGCGGN	GMP
BM3_TGCCGTCACATN	B
BM3_TGCCTCTATGAN	Mono
BM3_TGCCTTCCGAGA	lateEry
BM3_TGCCTTGTGGCA	ProMono
BM3_TGCGATCGGGCC	earlyEry
BM3_TGCGGCCTTTTA	cDC
BM3_TGCGTTCCTCGA	GMP
BM3_TGCTCCTTACAN	GMP
BM3_TGCTGATAATAT	Mono
BM3_TGCTGCAAGCTN	T
BM3_TGCTGGATCATA	T
BM3_TGCTTAAGTCGG	lateEry
BM3_TGCTTTCTCGGT	GMP
BM3_TGGATGTAGTTN	T
BM3_TGGATTGGTTTG	cDC
BM3_TGGGATGTGTTN	pDC
BM3_TGGGTAGACGCC	lateEry
BM3_TGGTCATCGTGA	GMP
BM3_TGGTTGCCAAGT	T
BM3_TGGTTGTAGAGN	Prog
BM3_TGGTTGTTAGAG	Prog
BM3_TGGTTTCTCGAG	lateEry
BM3_TGTAAACCGAGT	CTL
BM3_TGTAAGGATATN	ProMono
BM3_TGTACCGCAATG	ProMono
BM3_TGTACCTATGAC	Mono
BM3_TGTCATGACTTT	earlyEry
BM3_TGTGAGCCATAG	cDC
BM3_TGTGTAGGGCCC	pDC
BM3_TGTGTTTGGTAN	earlyEry
BM3_TGTTAGTGTTCA	ProMono
BM3_TGTTCCAGATAN	Mono
BM3_TGTTCGCATGGA	T
BM3_TGTTGTCCGAGN	earlyEry
BM3_TGTTTAGGATTN	T
BM3_TGTTTGGATTCN	ProMono
BM3_TGTTTTAGCCTN	Mono
BM3_TGTTTTATACCT	CTL
BM3_TTAAGCCTAATG	ProMono
BM3_TTAATACATGCA	GMP
BM3_TTAATTTCCATC	CTL
BM3_TTACACCAGGGT	earlyEry
BM3_TTACACCTCCGG	GMP
BM3_TTACTTCGCAAA	earlyEry
BM3_TTAGATATGGTA	NK
BM3_TTAGTAAAATTT	T
BM3_TTAGTGATGACG	GMP
BM3_TTATACTAGGAT	lateEry
BM3_TTCACAGATGTC	lateEry
BM3_TTCATGCGATTA	T
BM3_TTCATTTGTGTT	Mono
BM3_TTCCAGGATTAA	B
BM3_TTCCGTGCCACA	lateEry
BM3_TTCGAGTCATGA	GMP
BM3_TTCGCATAAAAT	earlyEry
BM3_TTCGCCGTCAAN	Mono
BM3_TTCTCGGGTAGG	earlyEry
BM3_TTGACCCAGGCA	Prog
BM3_TTGCGGATGTAN	T
BM3_TTGGAGTTGTGN	lateEry
BM3_TTGGCCGGACCC	T
BM3_TTGGTTGGTGAG	NK
BM3_TTGGTTTATTTA	GMP
BM3_TTGTGCGGCGGC	earlyEry
BM3_TTTAAATCCCGT	ProMono
BM3_TTTCGCAAACTG	earlyEry
BM3_TTTGCGTCGGCG	earlyEry
BM3_TTTGCGTTAGGN	earlyEry
BM3_TTTTAAAACCCN	ProMono
BM3_TTTTGAGGCAGT	cDC
BM3_TTTTGAGGCTGG	ProMono
BM3_TTTTGATTTTCT	HSC
BM5-34p_AAAAAGGGTTGA	HSC
BM5-34p_AAAACGTCCTTC	HSC
BM5-34p_AAAAGAAATATG	HSC
BM5-34p_AAACATACACGT	ProB
BM5-34p_AAACTACCAGTC	Prog
BM5-34p_AAACTCTTGTTC	HSC
BM5-34p_AAACTTTCTCCC	Prog
BM5-34p_AAAGAGGGGATA	Prog
BM5-34p_AAAGGTACTTAT	Prog
BM5-34p_AAAGGTATTCAG	HSC
BM5-34p_AAAGGTCGGGGG	HSC
BM5-34p_AAATACCAAGCG	Prog
BM5-34p_AAATCCACGGGT	Prog
BM5-34p_AAATGACGGTCA	HSC
BM5-34p_AAATGCAACTTG	HSC
BM5-34p_AAATGTGTGTTA	Prog
BM5-34p_AAATTGAGCGAG	HSC
BM5-34p_AAATTGCAGTGT	earlyEry
BM5-34p_AACAACGCCCTT	HSC
BM5-34p_AACAAGATAGTT	Prog
BM5-34p_AACAGTAGGGGT	HSC
BM5-34p_AACCAACGCGGG	HSC
BM5-34p_AACCACGCGTCT	ProB
BM5-34p_AACCCCTCGTGG	Prog
BM5-34p_AACCCTGGTGAT	HSC
BM5-34p_AACCGGACCAGT	Prog
BM5-34p_AACCGGTTCCTG	Prog
BM5-34p_AACCTATTTGGT	earlyEry
BM5-34p_AACGAATCCGGG	earlyEry
BM5-34p_AACGACAACTAG	HSC
BM5-34p_AACGACCTAAGC	HSC
BM5-34p_AACGAGAGTAAT	HSC
BM5-34p_AACGCTTCCCGA	HSC
BM5-34p_AACGGAGAAAGC	HSC
BM5-34p_AACGGCGAAGCG	Prog
BM5-34p_AACGGGCGCGTT	Prog
BM5-34p_AACGGTGAGTCC	Prog
BM5-34p_AACGTAGTGTTA	Prog
BM5-34p_AACTAAATATGT	earlyEry
BM5-34p_AACTACAAACAG	Prog
BM5-34p_AACTACGATTCA	HSC
BM5-34p_AACTATGTGCCA	Prog
BM5-34p_AACTCCCCAGCC	Prog
BM5-34p_AACTCTCCTATT	Prog
BM5-34p_AACTTGACCTTC	Prog
BM5-34p_AACTTTTACAGG	Prog
BM5-34p_AAGAAACCCACT	Prog
BM5-34p_AAGAACTGCCTG	ProB
BM5-34p_AAGAGCGTTTAT	Prog
BM5-34p_AAGATCACCCTT	HSC
BM5-34p_AAGCAGACTTTA	Prog
BM5-34p_AAGCATGCATGA	Prog
BM5-34p_AAGCCCCTCATT	Prog
BM5-34p_AAGCCGCAATAG	HSC
BM5-34p_AAGCCTTCATTC	HSC
BM5-34p_AAGCGAAAGCAT	GMP
BM5-34p_AAGCGCGGCCGC	Prog
BM5-34p_AAGCTGATGCGT	GMP
BM5-34p_AAGCTGCATGGA	Prog
BM5-34p_AAGCTGTATCCT	HSC
BM5-34p_AAGCTTAACGGA	GMP
BM5-34p_AAGGAACATACG	Prog
BM5-34p_AAGGACTTTGAA	Prog
BM5-34p_AAGGCTAACCAA	Prog
BM5-34p_AAGGCTGTGAGT	HSC
BM5-34p_AAGGGACATAGG	Prog
BM5-34p_AAGGGAGGTACA	Prog
BM5-34p_AAGGGCAGGCTC	Prog
BM5-34p_AAGGGGCAGCGC	HSC
BM5-34p_AAGGGTACGTCT	Prog
BM5-34p_AAGTAACGTCCG	HSC
BM5-34p_AAGTCCGGACGG	HSC
BM5-34p_AAGTGGACCATA	ProB
BM5-34p_AAGTGGATCGTG	HSC
BM5-34p_AATACACCGTGT	HSC
BM5-34p_AATAGGGCCATG	HSC
BM5-34p_AATAGTAGCGCG	Prog
BM5-34p_AATCAGGCTACT	Prog
BM5-34p_AATCCACCTTCA	HSC
BM5-34p_AATCGAAATGAC	Prog
BM5-34p_AATCGGACTGTT	Prog
BM5-34p_AATCTCAACTGG	Prog
BM5-34p_AATCTTTTCTAT	Prog
BM5-34p_AATGCATCACAA	HSC
BM5-34p_AATGGGAAGGGA	ProB
BM5-34p_AATGGTACGAGA	Prog
BM5-34p_AATGTAACGCGA	HSC
BM5-34p_AATGTATTCGCT	GMP
BM5-34p_AATGTCAAACAG	HSC
BM5-34p_AATGTCACTCAT	HSC
BM5-34p_AATGTCCCATAC	Prog
BM5-34p_AATTAACCGTTT	earlyEry
BM5-34p_AATTAATCCCAA	earlyEry
BM5-34p_AATTATCTCCGA	HSC
BM5-34p_AATTGGGATGGA	HSC
BM5-34p_AATTGTGTCGAA	Prog
BM5-34p_AATTGTTATAAC	Prog
BM5-34p_AATTTATGCCAT	ProB
BM5-34p_AATTTCCAACAG	GMP
BM5-34p_AATTTCCCTCGT	Prog
BM5-34p_ACAACCCTTCTT	Prog
BM5-34p_ACAAGTAGCGGT	GMP
BM5-34p_ACAATACGAGAC	GMP
BM5-34p_ACAATCTAGTGC	HSC
BM5-34p_ACACACGGTCTT	Prog
BM5-34p_ACACACTTCAGG	Prog
BM5-34p_ACACATATCATT	Prog
BM5-34p_ACACGAGACGCC	HSC
BM5-34p_ACACGTTGAAGG	HSC
BM5-34p_ACACTACCACTC	HSC
BM5-34p_ACAGAATAAACG	earlyEry
BM5-34p_ACAGAGCCGCTG	GMP
BM5-34p_ACAGATAACGTT	Prog
BM5-34p_ACAGCCTGCGAC	HSC
BM5-34p_ACAGGTGCTGGT	HSC
BM5-34p_ACAGTTACCGAA	Prog
BM5-34p_ACAGTTCTAGGT	earlyEry
BM5-34p_ACATAAGTTCCA	ProB
BM5-34p_ACATACATGTCA	HSC
BM5-34p_ACATGATGAGGG	earlyEry
BM5-34p_ACATGCGCCGCC	Prog
BM5-34p_ACCAATTCCCCA	HSC
BM5-34p_ACCACGTGTATC	Prog
BM5-34p_ACCACTTACAGG	HSC
BM5-34p_ACCATTCGAAGT	Prog
BM5-34p_ACCCCACCGTAC	Prog
BM5-34p_ACCCCCATATTA	earlyEry
BM5-34p_ACCCTGCCAGGA	HSC
BM5-34p_ACCGACATAGGA	Prog
BM5-34p_ACCGCCACGCGC	HSC
BM5-34p_ACCGGCTACGCT	HSC
BM5-34p_ACCGTATTCGTC	Prog
BM5-34p_ACCGTCCACTTG	HSC
BM5-34p_ACCGTCTGGGTG	GMP
BM5-34p_ACCGTGGAGCAG	HSC
BM5-34p_ACCGTGGCCTAG	Prog
BM5-34p_ACCGTTGGCCCG	GMP
BM5-34p_ACCTAATTAAGC	HSC
BM5-34p_ACCTCTAAAGGT	HSC
BM5-34p_ACCTGGAGTAAT	Prog
BM5-34p_ACCTGGCTAGTG	Prog
BM5-34p_ACCTTACGCCTT	Prog
BM5-34p_ACCTTATCATCT	HSC
BM5-34p_ACGACAACGCGA	Prog
BM5-34p_ACGACGTTCCTG	HSC
BM5-34p_ACGAGAGCGCCT	HSC
BM5-34p_ACGAGTCCAGGT	Prog
BM5-34p_ACGATATGGGTG	Prog
BM5-34p_ACGATCTTTCCA	Prog
BM5-34p_ACGCAATGGAAT	Prog
BM5-34p_ACGCACAATTGT	Prog
BM5-34p_ACGCACCCCTGT	ProB
BM5-34p_ACGCCGACCAGT	Prog
BM5-34p_ACGCGACCTACC	GMP
BM5-34p_ACGCTATCTGGG	Prog
BM5-34p_ACGCTCTCACAG	HSC
BM5-34p_ACGGCAACGCAG	earlyEry
BM5-34p_ACGGCAGGGCGG	HSC
BM5-34p_ACGGCCCTTACT	HSC
BM5-34p_ACGGTGACCAAG	Prog
BM5-34p_ACGGTTACTCAT	HSC
BM5-34p_ACGTAACTACGC	Prog
BM5-34p_ACGTACTATCGT	HSC
BM5-34p_ACGTCATGAAGT	cDC
BM5-34p_ACGTCATGCTTC	HSC
BM5-34p_ACGTCATGTATC	Prog
BM5-34p_ACGTCATTAGGT	earlyEry
BM5-34p_ACGTCGAGGGAA	Prog
BM5-34p_ACGTGGCTCTGT	earlyEry
BM5-34p_ACGTTAGCGGCG	Prog
BM5-34p_ACGTTTTTACGA	Prog
BM5-34p_ACTACGAGCGGG	Prog
BM5-34p_ACTACGCCGTTC	HSC
BM5-34p_ACTAGGCTAATC	GMP
BM5-34p_ACTAGTCACTTT	GMP
BM5-34p_ACTAGTGAGGGG	HSC
BM5-34p_ACTATAGGGATA	HSC
BM5-34p_ACTATCTTCATC	HSC
BM5-34p_ACTATTGGTTGA	Prog
BM5-34p_ACTCAGACCTTG	HSC
BM5-34p_ACTCAGGTGGGT	HSC
BM5-34p_ACTCATAAGATC	Prog
BM5-34p_ACTCCCACTCTA	earlyEry
BM5-34p_ACTCGACTCCGG	Prog
BM5-34p_ACTCTAGTTAGC	ProB
BM5-34p_ACTCTATTTACG	GMP
BM5-34p_ACTCTGAACTCT	Prog
BM5-34p_ACTGAACTGGCC	HSC
BM5-34p_ACTGGGCACTTA	Prog
BM5-34p_ACTGTCGAGAGG	GMP
BM5-34p_ACTGTGGAGCGT	HSC
BM5-34p_ACTTATATTATG	Prog
BM5-34p_ACTTCGGGCGAC	earlyEry
BM5-34p_ACTTGAAAGTGT	ProB
BM5-34p_ACTTGCTGCAAC	pDC
BM5-34p_AGAAAAGGTATC	HSC
BM5-34p_AGAACACTGAGG	HSC
BM5-34p_AGAAGTCATTAA	earlyEry
BM5-34p_AGAATAGCTAGT	Prog
BM5-34p_AGAATCTTAACA	Prog
BM5-34p_AGAATGTTGCAG	Prog
BM5-34p_AGACAGTGCTAC	earlyEry
BM5-34p_AGACGGTTGCGG	HSC
BM5-34p_AGACTGAAAGGC	HSC
BM5-34p_AGAGCCTCATAA	HSC
BM5-34p_AGAGGAGTATGG	Prog
BM5-34p_AGAGGCTTAGCG	Prog
BM5-34p_AGAGGTAACATC	Prog
BM5-34p_AGAGTCCGTTGT	HSC
BM5-34p_AGAGTCTTATGC	Prog
BM5-34p_AGATAGCCTCAC	Prog
BM5-34p_AGATAGCGTATG	earlyEry
BM5-34p_AGATCCCGACTT	Prog
BM5-34p_AGATCGAGCAAG	Prog
BM5-34p_AGATCGCTTCCT	Prog
BM5-34p_AGATCTCTCTTG	ProB
BM5-34p_AGATGACCGGGA	HSC
BM5-34p_AGATGGAGATTG	earlyEry
BM5-34p_AGATGGTCAGTG	earlyEry
BM5-34p_AGCAACTGCCGG	earlyEry
BM5-34p_AGCAAGCTGTGG	GMP
BM5-34p_AGCACCCGCTTT	GMP
BM5-34p_AGCACGCCGACT	HSC
BM5-34p_AGCACGTAGTTC	earlyEry
BM5-34p_AGCAGAAGTTGG	HSC
BM5-34p_AGCATCTCATGC	HSC
BM5-34p_AGCATGGCTTGA	Prog
BM5-34p_AGCATGTGGCCC	Prog
BM5-34p_AGCCGCTTTTGC	Prog
BM5-34p_AGCCTTCCATCG	Prog
BM5-34p_AGCGATGACGTT	Prog
BM5-34p_AGCGCATCAGGG	Prog
BM5-34p_AGCGGAAGTCGA	Prog
BM5-34p_AGCGTACTCGAA	Prog
BM5-34p_AGCGTGTGTTCG	GMP
BM5-34p_AGCTACCCATGT	ProB
BM5-34p_AGCTATACCGAT	pDC
BM5-34p_AGCTCCTCATAG	HSC
BM5-34p_AGCTGCATTTAG	GMP
BM5-34p_AGCTTAACTTCA	Prog
BM5-34p_AGCTTATGTCCC	Prog
BM5-34p_AGCTTCCCCCTG	Prog
BM5-34p_AGGAATCAAATG	Prog
BM5-34p_AGGACATCTCAG	HSC
BM5-34p_AGGACGTGACCA	Prog
BM5-34p_AGGAGCCGCCTG	Prog
BM5-34p_AGGAGCTTTCAG	HSC
BM5-34p_AGGAGTAAATCC	Prog
BM5-34p_AGGATCGGCTCA	HSC
BM5-34p_AGGATGGATAAG	HSC
BM5-34p_AGGATTCTGAGA	earlyEry
BM5-34p_AGGCGCCGCTCA	ProB
BM5-34p_AGGCTTGTAGTA	pDC
BM5-34p_AGGGAGGCCCTG	HSC
BM5-34p_AGGGGCAGGAAC	HSC
BM5-34p_AGGGTACGGGCA	Prog
BM5-34p_AGGGTCTTCCTT	HSC
BM5-34p_AGGGTTGCTTCA	GMP
BM5-34p_AGGTATTATGAT	HSC
BM5-34p_AGGTCCTCAGCG	Prog
BM5-34p_AGGTCTGCCCTC	earlyEry
BM5-34p_AGGTGACGTGGA	HSC
BM5-34p_AGGTGGAAGCGG	Prog
BM5-34p_AGGTGGACATTC	HSC
BM5-34p_AGGTGGTCCCGT	Prog
BM5-34p_AGGTGTGATAGC	HSC
BM5-34p_AGGTTCTGAATA	GMP
BM5-34p_AGGTTTTGGCTC	HSC
BM5-34p_AGTAAAAACCGT	ProB
BM5-34p_AGTAACACAACT	Prog
BM5-34p_AGTAAGAGCCGT	ProB
BM5-34p_AGTATGTTCGCT	HSC
BM5-34p_AGTATTAAGGAG	HSC
BM5-34p_AGTCACCCATCC	HSC
BM5-34p_AGTCACTTCTGT	HSC
BM5-34p_AGTCCACACCAT	HSC
BM5-34p_AGTCCGGAGTCT	Prog
BM5-34p_AGTCCTGCACTC	ProB
BM5-34p_AGTCGAACCTTN	Prog
BM5-34p_AGTCTACTGCAA	HSC
BM5-34p_AGTCTATCGTTC	Prog
BM5-34p_AGTCTCGATATT	Prog
BM5-34p_AGTGAAAAGAAA	Prog
BM5-34p_AGTGACTTTCTC	Prog
BM5-34p_AGTGAGCCTTAG	Prog
BM5-34p_AGTGCAGCGCGC	Prog
BM5-34p_AGTGCATCTACA	Prog
BM5-34p_AGTGCGGCACTC	Prog
BM5-34p_AGTGGATCTTTT	earlyEry
BM5-34p_AGTGGGCGGACA	Prog
BM5-34p_AGTGGTACGTTA	ProB
BM5-34p_AGTGTATGTCTT	Prog
BM5-34p_AGTTATCATACC	HSC
BM5-34p_AGTTATGGCTTC	HSC
BM5-34p_AGTTGAAAGTTC	Prog
BM5-34p_AGTTGCCCAGAA	HSC
BM5-34p_AGTTGTTTCCGG	GMP
BM5-34p_ATAAAATTTCAA	Prog
BM5-34p_ATAACAGACCAT	GMP
BM5-34p_ATAACAGGGGGT	cDC
BM5-34p_ATAAGAGTATGT	Prog
BM5-34p_ATAAGCCACTGA	GMP
BM5-34p_ATAAGGTTCACC	HSC
BM5-34p_ATAAGTTGCAGG	HSC
BM5-34p_ATAATACATGTG	Prog
BM5-34p_ATACACCATTGG	GMP
BM5-34p_ATACAGACGCAA	Prog
BM5-34p_ATACAGCTCTGG	ProB
BM5-34p_ATACATTCCGTC	Prog
BM5-34p_ATACCAAGTTGT	HSC
BM5-34p_ATACGGCTAGTC	Prog
BM5-34p_ATACGTGTTGGT	Prog
BM5-34p_ATAGATGTTCAC	Prog
BM5-34p_ATAGCATTTCTG	Prog
BM5-34p_ATAGGCCCTTCN	GMP
BM5-34p_ATAGGTATGGCT	HSC
BM5-34p_ATATACGTTACT	HSC
BM5-34p_ATATATGGGCTA	HSC
BM5-34p_ATATCGCTAGTC	earlyEry
BM5-34p_ATATGCACAGAG	Prog
BM5-34p_ATATGCAGAACG	Prog
BM5-34p_ATATGTCAAGGA	GMP
BM5-34p_ATATTCATGCAC	ProB
BM5-34p_ATATTGTCTAGC	HSC
BM5-34p_ATATTTAGTTAG	Prog
BM5-34p_ATCAAGAGTCAT	HSC
BM5-34p_ATCAAGATTGCA	HSC
BM5-34p_ATCACGCCACAA	Prog
BM5-34p_ATCAGACTCGGA	Prog
BM5-34p_ATCAGATGGGCA	Prog
BM5-34p_ATCATATTTGTG	Prog
BM5-34p_ATCATGGTGATG	Prog
BM5-34p_ATCCAGGCTATG	HSC
BM5-34p_ATCCAGTCGACA	Prog
BM5-34p_ATCCATTTGTCC	HSC
BM5-34p_ATCCCAACACCT	GMP
BM5-34p_ATCCGAGATGAC	ProB
BM5-34p_ATCCGGATCGCC	Prog
BM5-34p_ATCGAGAGTCGT	HSC
BM5-34p_ATCGCTCGGCCT	Prog
BM5-34p_ATCGGCACGAGG	Prog
BM5-34p_ATCGGGCCAGCG	HSC
BM5-34p_ATCTCAGACATG	Prog
BM5-34p_ATCTCAGAGGCA	Prog
BM5-34p_ATCTGGCCCTAT	Prog
BM5-34p_ATGAGATTAGTC	HSC
BM5-34p_ATGAGCTGATTT	Prog
BM5-34p_ATGATACCTTTA	earlyEry
BM5-34p_ATGCAGCTATTT	HSC
BM5-34p_ATGCATCGACTG	Prog
BM5-34p_ATGCGAGTTGAG	Prog
BM5-34p_ATGCGTTTGTTA	GMP
BM5-34p_ATGCTAGGCATA	HSC
BM5-34p_ATGCTCAAGGCG	HSC
BM5-34p_ATGTAACCCAGA	Prog
BM5-34p_ATGTCACTATAA	ProB
BM5-34p_ATGTCAGTAGTT	earlyEry
BM5-34p_ATGTCGGGGCGC	Prog
BM5-34p_ATGTTTTCTAAG	GMP
BM5-34p_ATTAAAGCCTAT	Prog
BM5-34p_ATTAAATCGAGG	Prog
BM5-34p_ATTAATCGAAGA	Prog
BM5-34p_ATTACTGCTCTT	HSC
BM5-34p_ATTATACTTCAG	earlyEry
BM5-34p_ATTATCTAGCCT	earlyEry
BM5-34p_ATTATTATCGTC	HSC
BM5-34p_ATTCATACATTG	Prog
BM5-34p_ATTCCAGGCTAC	HSC
BM5-34p_ATTCTAATACCG	Prog
BM5-34p_ATTCTTACCTCA	HSC
BM5-34p_ATTGAAACCTTA	Prog
BM5-34p_ATTGAATGGAAT	Prog
BM5-34p_ATTGCTTCGGAG	HSC
BM5-34p_ATTGGAGTAAGA	HSC
BM5-34p_ATTGTTATCGGC	Prog
BM5-34p_ATTTCCGGGCCG	Prog
BM5-34p_ATTTCGCGTCCT	HSC
BM5-34p_ATTTGCTTCTAA	HSC
BM5-34p_ATTTTAATCGCT	Prog
BM5-34p_ATTTTATTACTT	HSC
BM5-34p_CAAAAGTCAGAG	GMP
BM5-34p_CAAACGAGCCTC	HSC
BM5-34p_CAAATACCCATA	Prog
BM5-34p_CAACCAACGATG	Prog
BM5-34p_CAACCATCATGC	Prog
BM5-34p_CAACGCGGCCGA	Prog
BM5-34p_CAACTCCAAATG	HSC
BM5-34p_CAACTTCCATTC	Prog
BM5-34p_CAACTTTTTGAG	Prog
BM5-34p_CAAGAATTTCAA	HSC
BM5-34p_CAAGCAAGAGCT	Prog
BM5-34p_CAATAATAGTGA	ProB
BM5-34p_CAATGGTCGGCC	GMP
BM5-34p_CAATGTTGTAAT	Prog
BM5-34p_CACAACCACGCA	Prog
BM5-34p_CACAAGTAACGC	GMP
BM5-34p_CACACAGAGAGT	Prog
BM5-34p_CACAGCGGCCGG	Prog
BM5-34p_CACAGTAGTAGG	HSC
BM5-34p_CACATACCCTGT	Prog
BM5-34p_CACATACGAACG	ProB
BM5-34p_CACATTTTAGAA	Prog
BM5-34p_CACCCCCCGCTG	GMP
BM5-34p_CACCGCGGATGT	GMP
BM5-34p_CACCTTACAGTG	Prog
BM5-34p_CACGAAAGGATA	HSC
BM5-34p_CACGCTTCCATT	earlyEry
BM5-34p_CACGGACGAGCC	HSC
BM5-34p_CACGTCAACACT	Prog
BM5-34p_CACGTTCCAGCC	HSC
BM5-34p_CACTCAATAAGA	Prog
BM5-34p_CACTCCCTAACT	earlyEry
BM5-34p_CACTCGTCCTTC	Prog
BM5-34p_CACTCTGGTCTA	Prog
BM5-34p_CACTGGTCGCCT	Prog
BM5-34p_CACTGTCATCTA	Prog
BM5-34p_CACTGTTGCATG	HSC
BM5-34p_CACTTATTGCCG	Prog
BM5-34p_CAGAGTAACGGC	Prog
BM5-34p_CAGCACAAAATC	HSC
BM5-34p_CAGCACTCGTTC	Prog
BM5-34p_CAGCCATTTACT	HSC
BM5-34p_CAGCTAGGTCCG	Prog
BM5-34p_CAGGCCGTCACC	HSC
BM5-34p_CAGGCCTAGCAG	earlyEry
BM5-34p_CAGGGATTCGCA	Prog
BM5-34p_CAGGGTGAACTC	HSC
BM5-34p_CAGGGTGACTTG	Prog
BM5-34p_CAGTAGAATACC	earlyEry
BM5-34p_CAGTATTAGCAT	Prog
BM5-34p_CAGTCCTCACCA	Prog
BM5-34p_CAGTCGAATCGA	ProB
BM5-34p_CAGTGTCTTCAG	Prog
BM5-34p_CAGTTGAGCCCA	earlyEry
BM5-34p_CATAGTCTCCCA	Prog
BM5-34p_CATAGTTTTGAG	HSC
BM5-34p_CATATACAACGA	pDC
BM5-34p_CATATGCGTCGG	Prog
BM5-34p_CATCATTTTTTA	Prog
BM5-34p_CATCCAAGACCG	HSC
BM5-34p_CATCCGCGACTG	HSC
BM5-34p_CATCCGCTCCTT	HSC
BM5-34p_CATCCGCTGGAG	Prog
BM5-34p_CATCGGCCAACA	Prog
BM5-34p_CATCTCGTCGCT	HSC
BM5-34p_CATGATGTAGGG	HSC
BM5-34p_CATGCGCTGAAC	Prog
BM5-34p_CATGGACCGAGC	Prog
BM5-34p_CATGGTAAGTTA	Prog
BM5-34p_CATGTAAGATTC	ProB
BM5-34p_CATGTTCGTTCG	earlyEry
BM5-34p_CATTACGCGCTC	HSC
BM5-34p_CATTGCTTAGTA	earlyEry
BM5-34p_CCAACAGCTATT	earlyEry
BM5-34p_CCAACCATCGAA	ProB
BM5-34p_CCAACTATTACC	Prog
BM5-34p_CCAAGCTTGTTA	Prog
BM5-34p_CCAATTTTAGTA	Prog
BM5-34p_CCACATCACTCA	Prog
BM5-34p_CCACCCTCGTCC	Prog
BM5-34p_CCACGAGGGCTC	HSC
BM5-34p_CCACTGTCATAC	HSC
BM5-34p_CCACTTCATTCT	HSC
BM5-34p_CCAGGAGGCGGT	Prog
BM5-34p_CCAGTACAGAAT	Prog
BM5-34p_CCAGTGGCGTCT	Prog
BM5-34p_CCATACTAGTTG	HSC
BM5-34p_CCATATCGCAAG	ProB
BM5-34p_CCATCATACCCA	Prog
BM5-34p_CCATCGCGTACT	HSC
BM5-34p_CCATGAATATCC	Prog
BM5-34p_CCATGACGAGAG	ProB
BM5-34p_CCATGAGCATTA	Prog
BM5-34p_CCATGGTGTACA	Prog
BM5-34p_CCATGTAATCGC	Prog
BM5-34p_CCATGTCCCGGG	Prog
BM5-34p_CCATTAGTGATT	Prog
BM5-34p_CCATTAGTTTTT	HSC
BM5-34p_CCATTGATTATC	Prog
BM5-34p_CCCAAATCCAGA	HSC
BM5-34p_CCCAGACTGATG	HSC
BM5-34p_CCCAGTTGTGTT	Prog
BM5-34p_CCCATAGCTCCC	GMP
BM5-34p_CCCATTTGGAGA	Prog
BM5-34p_CCCCACGTGGAA	Prog
BM5-34p_CCCCCTTCGCGG	HSC
BM5-34p_CCCCGAGCACAT	Prog
BM5-34p_CCCCGATTTTCG	Prog
BM5-34p_CCCCGCTTTACC	Prog
BM5-34p_CCCCGTCTCTAC	Prog
BM5-34p_CCCCGTTGGGGT	Prog
BM5-34p_CCCCTACATACC	HSC
BM5-34p_CCCCTGGCGTGG	HSC
BM5-34p_CCCGCTTTATTA	HSC
BM5-34p_CCCTACACTTAC	earlyEry
BM5-34p_CCCTATAGGTCT	Prog
BM5-34p_CCCTCGGGGTGA	Prog
BM5-34p_CCCTGTTAACGG	earlyEry
BM5-34p_CCCTTACGAACA	Prog
BM5-34p_CCCTTCTGGACA	HSC
BM5-34p_CCCTTGGCTCCT	earlyEry
BM5-34p_CCGAACAGGTCG	Prog
BM5-34p_CCGAGCGCTCAG	Prog
BM5-34p_CCGCAAGGTAAG	ProMono
BM5-34p_CCGCCAGGCAAA	HSC
BM5-34p_CCGCCGCGGGGC	HSC
BM5-34p_CCGCCTGATAGC	earlyEry
BM5-34p_CCGCGCTACTGG	HSC
BM5-34p_CCGCGGGGCAGT	Prog
BM5-34p_CCGCGTCTGTTT	Prog
BM5-34p_CCGCTAGGTTCA	Prog
BM5-34p_CCGGACCAAGAA	Prog
BM5-34p_CCGGCTCCTAAG	HSC
BM5-34p_CCGGCTGCGTAA	pDC
BM5-34p_CCGGGTACTTCT	GMP
BM5-34p_CCGGTTGTATAA	HSC
BM5-34p_CCGTATCGGTGT	earlyEry
BM5-34p_CCGTGAATTCTA	GMP
BM5-34p_CCTAACGTAGGA	earlyEry
BM5-34p_CCTAATGGCCCA	Prog
BM5-34p_CCTATAAGGTGC	HSC
BM5-34p_CCTATATCACGC	HSC
BM5-34p_CCTATGCCAGGA	Prog
BM5-34p_CCTATGTCAGAA	Prog
BM5-34p_CCTATTGATACT	Prog
BM5-34p_CCTCATCGACCA	HSC
BM5-34p_CCTCCAGCGAAA	Prog
BM5-34p_CCTCCCAACCGG	Prog
BM5-34p_CCTCCCCGTATA	Prog
BM5-34p_CCTCCTCTAGGA	earlyEry
BM5-34p_CCTCGAGCCCTC	Prog
BM5-34p_CCTCGATTTCCC	Prog
BM5-34p_CCTCGCCGTTTG	earlyEry
BM5-34p_CCTCTAACAGCA	Prog
BM5-34p_CCTCTGGAATAC	Prog
BM5-34p_CCTGAGAAAAGG	ProB
BM5-34p_CCTGAGACGCGC	HSC
BM5-34p_CCTGGCATGATT	Prog
BM5-34p_CCTGGCCTCACA	HSC
BM5-34p_CCTTAATTTGTA	GMP
BM5-34p_CCTTCGCTGGCG	Prog
BM5-34p_CCTTTGCTACAA	Prog
BM5-34p_CCTTTGGGGAAG	Prog
BM5-34p_CCTTTTGGTTCC	HSC
BM5-34p_CGAACACAGTAG	HSC
BM5-34p_CGAACGGCCTCG	Prog
BM5-34p_CGAAGTTTGCTA	HSC
BM5-34p_CGAATGCGTTAG	HSC
BM5-34p_CGAATGGATAGT	GMP
BM5-34p_CGACCATGGGTA	HSC
BM5-34p_CGACCGGACGCC	earlyEry
BM5-34p_CGACGCCGACAT	HSC
BM5-34p_CGACTCTCAGTT	HSC
BM5-34p_CGACTGTCTATG	earlyEry
BM5-34p_CGAGACAGGTCA	pDC
BM5-34p_CGAGACGCCAGC	Prog
BM5-34p_CGAGAGGAACTG	Prog
BM5-34p_CGAGCGACTGAA	GMP
BM5-34p_CGAGGGAGTCCA	Prog
BM5-34p_CGAGGGTCGGAG	HSC
BM5-34p_CGAGTTGGACCT	HSC
BM5-34p_CGATAAGGGTAG	Prog
BM5-34p_CGATAATATTGA	earlyEry
BM5-34p_CGATGTAAGTAC	Prog
BM5-34p_CGATTCAACCGA	Prog
BM5-34p_CGCAAGATATAG	Prog
BM5-34p_CGCACAGGCTGC	HSC
BM5-34p_CGCACTAAGCTC	HSC
BM5-34p_CGCAGGCACTTA	Prog
BM5-34p_CGCAGGTCTCTC	Prog
BM5-34p_CGCAGTTGCGAA	GMP
BM5-34p_CGCCCGGGCGCC	GMP
BM5-34p_CGCCCTAGGATC	HSC
BM5-34p_CGCCCTCGGAAT	HSC
BM5-34p_CGCCGAAAAGCA	earlyEry
BM5-34p_CGCCTGGTCGGG	HSC
BM5-34p_CGCCTTACAAAA	HSC
BM5-34p_CGCCTTTTTAGA	earlyEry
BM5-34p_CGCGACTGGGAT	Prog
BM5-34p_CGCGCCACGCAG	Prog
BM5-34p_CGCGCTGCAGGA	Prog
BM5-34p_CGCGTACGGATC	Prog
BM5-34p_CGCGTGAGCCGA	HSC
BM5-34p_CGCGTGTCCCAA	Prog
BM5-34p_CGCTCTTACATG	Prog
BM5-34p_CGCTGATATACA	cDC
BM5-34p_CGCTGTCCCTTG	Prog
BM5-34p_CGCTTAACTAAG	Prog
BM5-34p_CGCTTGCTTTTA	Prog
BM5-34p_CGCTTTTCTTAT	Prog
BM5-34p_CGGAACTCGTTC	HSC
BM5-34p_CGGAAGCCTACA	GMP
BM5-34p_CGGAATGATTCT	HSC
BM5-34p_CGGACACCTGAT	HSC
BM5-34p_CGGACGACTCGG	GMP
BM5-34p_CGGACGTAAGTT	Prog
BM5-34p_CGGACTTGCTAG	Prog
BM5-34p_CGGACTTTCGTC	Prog
BM5-34p_CGGATTGATGAA	HSC
BM5-34p_CGGCCTCGTACA	Prog
BM5-34p_CGGCGGCCAGGC	GMP
BM5-34p_CGGCTGTCCTCA	Mono
BM5-34p_CGGGAAACCGTC	GMP
BM5-34p_CGGGAAGCTACA	HSC
BM5-34p_CGGGAATTAACC	Prog
BM5-34p_CGGGACTCTTCT	HSC
BM5-34p_CGGTCGCGCTGN	Prog
BM5-34p_CGGTGCATCACA	pDC
BM5-34p_CGGTGTTCTCTG	HSC
BM5-34p_CGGTTGGACGGG	Prog
BM5-34p_CGGTTTCCAGTT	GMP
BM5-34p_CGGTTTGTGCAC	Prog
BM5-34p_CGTAACGGCGTG	HSC
BM5-34p_CGTACTTCTACT	ProB
BM5-34p_CGTAGAGAATGC	Prog
BM5-34p_CGTATGGGTTGT	Prog
BM5-34p_CGTCAGTCTATG	Prog
BM5-34p_CGTCCAGCTCGT	GMP
BM5-34p_CGTCCAGGACAG	Prog
BM5-34p_CGTCCAGGATCA	ProB
BM5-34p_CGTCCGCCTTGC	Prog
BM5-34p_CGTCGAAGTTAC	HSC
BM5-34p_CGTGAGGGCCAC	GMP
BM5-34p_CGTGATAAAATC	HSC
BM5-34p_CGTGCCTCACTT	Prog
BM5-34p_CGTGGTGGATAG	HSC
BM5-34p_CGTTATTATGAG	Prog
BM5-34p_CGTTCAGCGTAA	earlyEry
BM5-34p_CGTTCGAACGGC	Prog
BM5-34p_CGTTCGCCGCTG	Prog
BM5-34p_CGTTTAAGATCC	HSC
BM5-34p_CGTTTCGCTACG	HSC
BM5-34p_CGTTTCTCAGTT	HSC
BM5-34p_CGTTTCTGTGGA	Prog
BM5-34p_CGTTTGATCCTT	earlyEry
BM5-34p_CTAACATTAAAA	HSC
BM5-34p_CTAACCGCTTCA	HSC
BM5-34p_CTAACTGCATCT	Prog
BM5-34p_CTAAGTAATCAC	earlyEry
BM5-34p_CTAATAAGATGT	Prog
BM5-34p_CTAATGGTATCC	HSC
BM5-34p_CTACAACGATTA	GMP
BM5-34p_CTACCAGAAGTG	Prog
BM5-34p_CTACGGATAGGA	GMP
BM5-34p_CTACTAAGTTAT	HSC
BM5-34p_CTACTCGGATTA	Prog
BM5-34p_CTAGAGAAAGAG	earlyEry
BM5-34p_CTAGATGTTGGA	GMP
BM5-34p_CTAGCCGGTAGG	Prog
BM5-34p_CTAGGCGGCGGT	HSC
BM5-34p_CTAGGGCGTAAG	Prog
BM5-34p_CTAGGTCACAGG	HSC
BM5-34p_CTAGGTTGAAAA	Prog
BM5-34p_CTAGTAGCAGCG	HSC
BM5-34p_CTAGTCCTCCGA	GMP
BM5-34p_CTATACTTGTCG	Prog
BM5-34p_CTATCGCATTTA	Prog
BM5-34p_CTATCGGCCGGA	Prog
BM5-34p_CTATCTGTAAAT	earlyEry
BM5-34p_CTATCTTTCATC	HSC
BM5-34p_CTATGGCGGCGA	Prog
BM5-34p_CTATGTCCTCTT	GMP
BM5-34p_CTATTGGCGTAG	Prog
BM5-34p_CTATTTACGTTT	Prog
BM5-34p_CTATTTGTAGCG	GMP
BM5-34p_CTCAAGGCGGAA	Prog
BM5-34p_CTCAGCACCATC	Prog
BM5-34p_CTCAGTTATCCA	HSC
BM5-34p_CTCATGAAACAC	HSC
BM5-34p_CTCATGTAACTG	GMP
BM5-34p_CTCATGTCCCAT	Prog
BM5-34p_CTCCAACCGCGC	ProB
BM5-34p_CTCCAATTCACT	Prog
BM5-34p_CTCCACGGCGTA	Prog
BM5-34p_CTCCATAACGCA	HSC
BM5-34p_CTCCCCTCAGTG	Prog
BM5-34p_CTCCGTTTCTTC	Prog
BM5-34p_CTCCTCTACTGA	HSC
BM5-34p_CTCCTGTGCCGG	Prog
BM5-34p_CTCGCAGGAAGA	HSC
BM5-34p_CTCGCGCCAGAC	GMP
BM5-34p_CTCGGGCTATCT	Prog
BM5-34p_CTCGTGCGGTCC	Prog
BM5-34p_CTCTCCGATACT	Prog
BM5-34p_CTCTGCACAGGC	earlyEry
BM5-34p_CTCTGCGGCCCA	pDC
BM5-34p_CTCTGTATCAAA	HSC
BM5-34p_CTCTTCGCTCTC	Prog
BM5-34p_CTGAATTCCTGC	earlyEry
BM5-34p_CTGACTTGAAAT	HSC
BM5-34p_CTGAGTTTATCT	HSC
BM5-34p_CTGATACAGAAA	HSC
BM5-34p_CTGCACGTACTG	HSC
BM5-34p_CTGCCCCTTTTC	HSC
BM5-34p_CTGCCGCAGCTC	GMP
BM5-34p_CTGGAGATTGTN	Prog
BM5-34p_CTGGCTTCTAGC	earlyEry
BM5-34p_CTGGTCACATTG	HSC
BM5-34p_CTGGTGGGTGTC	HSC
BM5-34p_CTGGTTTCTGGG	HSC
BM5-34p_CTGTAAGACCCC	Prog
BM5-34p_CTGTAGTCATTA	HSC
BM5-34p_CTGTGCGCGTCT	HSC
BM5-34p_CTGTGCTCAGGT	Prog
BM5-34p_CTGTTTTAGTCC	Prog
BM5-34p_CTTACAACGAGA	Prog
BM5-34p_CTTACAGACGGC	Prog
BM5-34p_CTTACCGCTCTA	ProB
BM5-34p_CTTACCTGGATA	ProB
BM5-34p_CTTACTGCAAGG	Prog
BM5-34p_CTTAGTCCGGTA	HSC
BM5-34p_CTTAGTTTGAAA	HSC
BM5-34p_CTTATCGTTAGA	Prog
BM5-34p_CTTCAATTTGGC	Prog
BM5-34p_CTTCACACGGCC	ProB
BM5-34p_CTTCATAATTTA	Prog
BM5-34p_CTTCATTGCCCT	HSC
BM5-34p_CTTCCATCTACG	HSC
BM5-34p_CTTCCCAGATAT	earlyEry
BM5-34p_CTTCGACGCTCG	Prog
BM5-34p_CTTCGTATAGTG	HSC
BM5-34p_CTTCTAAGATTA	HSC
BM5-34p_CTTCTGAATCTC	Prog
BM5-34p_CTTCTTTGTAAG	HSC
BM5-34p_CTTGATAGCGAT	Prog
BM5-34p_CTTGCGAACGAC	HSC
BM5-34p_CTTGGGCGGTCG	GMP
BM5-34p_CTTGTATTCCAG	Prog
BM5-34p_CTTGTTACGTAA	Prog
BM5-34p_CTTTATGCCTCC	HSC
BM5-34p_CTTTCACGCGCC	Prog
BM5-34p_CTTTGGTATCCA	Prog
BM5-34p_GAAAACAAAACG	GMP
BM5-34p_GAAACACCTTAC	HSC
BM5-34p_GAAACTGTCGGA	HSC
BM5-34p_GAAAGTGTTAGC	Prog
BM5-34p_GAAATAGGACGA	Prog
BM5-34p_GAAATCGGGAGA	HSC
BM5-34p_GAAATTCCCCCC	Prog
BM5-34p_GAACAGATGTTC	HSC
BM5-34p_GAACGGGAATGG	earlyEry
BM5-34p_GAACTGAGCGAA	Prog
BM5-34p_GAACTTTTATCC	HSC
BM5-34p_GAAGATACTGAA	HSC
BM5-34p_GAAGGCATAGCA	Prog
BM5-34p_GAAGGCCTACAG	HSC
BM5-34p_GAAGTGCGTTTA	earlyEry
BM5-34p_GAATAACATCCC	earlyEry
BM5-34p_GAATGGCACCAA	GMP
BM5-34p_GAATTGGGTATT	Prog
BM5-34p_GACAATACTCTG	Prog
BM5-34p_GACAGTCACCGC	HSC
BM5-34p_GACCATTTAACA	Prog
BM5-34p_GACCCACCGCAC	Prog
BM5-34p_GACCCATGCCCG	Prog
BM5-34p_GACCCCCCGTGA	HSC
BM5-34p_GACCCTGAAGCG	Prog
BM5-34p_GACCGATCCCTT	Prog
BM5-34p_GACCTTGTTGAC	GMP
BM5-34p_GACGATCTTCTG	earlyEry
BM5-34p_GACGCCCTGAAC	Prog
BM5-34p_GACTGTTATTCT	HSC
BM5-34p_GACTTGCATATC	Prog
BM5-34p_GACTTGCCCCTT	Prog
BM5-34p_GAGAAAATCAGG	Prog
BM5-34p_GAGACGCGTCGG	HSC
BM5-34p_GAGAGCCTTGAT	Prog
BM5-34p_GAGCGGGGTTGT	HSC
BM5-34p_GAGCTCACTGTT	Prog
BM5-34p_GAGGATAATTCT	HSC
BM5-34p_GAGGGGTGAGAC	earlyEry
BM5-34p_GAGGTGTCATCT	Prog
BM5-34p_GAGTGACTCCGC	Prog
BM5-34p_GAGTTATCGCTC	earlyEry
BM5-34p_GAGTTCAAATAA	Prog
BM5-34p_GAGTTTGCCTTC	Prog
BM5-34p_GATAAAAGAGCG	Prog
BM5-34p_GATAATAACCGG	HSC
BM5-34p_GATACCAGTCGC	Prog
BM5-34p_GATAGTTACGCA	HSC
BM5-34p_GATATCATGGCT	HSC
BM5-34p_GATCATAGATCG	Prog
BM5-34p_GATCATAGGACG	Prog
BM5-34p_GATCTCTCTATC	Prog
BM5-34p_GATGGTCCTATC	HSC
BM5-34p_GATTGATATGGC	ProB
BM5-34p_GCAACGACCTTT	HSC
BM5-34p_GCAACGAGGTCC	HSC
BM5-34p_GCAAGTTATAGA	HSC
BM5-34p_GCAATGCAAGGC	Prog
BM5-34p_GCACAGCATCAT	HSC
BM5-34p_GCACTAACCACC	GMP
BM5-34p_GCACTCAAACCA	earlyEry
BM5-34p_GCAGACTTATAC	HSC
BM5-34p_GCAGAGATTTGG	HSC
BM5-34p_GCAGCAACCGCG	ProB
BM5-34p_GCAGCAAGCCCC	Prog
BM5-34p_GCAGGTTTTTGG	earlyEry
BM5-34p_GCATAGCGAATC	GMP
BM5-34p_GCATATCAGGCC	Prog
BM5-34p_GCATATGTATAT	HSC
BM5-34p_GCATCTTCTTCC	earlyEry
BM5-34p_GCATGAAATCCA	HSC
BM5-34p_GCATGGGGACTG	Prog
BM5-34p_GCATGTCACGTC	HSC
BM5-34p_GCCAATTGTCGA	Prog
BM5-34p_GCCAGAGGGCGA	HSC
BM5-34p_GCCAGCTTAGAA	Prog
BM5-34p_GCCAGGTATGAG	Prog
BM5-34p_GCCATATACAAG	HSC
BM5-34p_GCCATTCTAGCA	HSC
BM5-34p_GCCCAGGCCGGA	HSC
BM5-34p_GCCCCGTTGAGC	Prog
BM5-34p_GCCCGATAGCCT	Prog
BM5-34p_GCCCTACTGGTG	Prog
BM5-34p_GCCCTGGGAATC	HSC
BM5-34p_GCCGGATCCATG	HSC
BM5-34p_GCCGTGAGGCGC	HSC
BM5-34p_GCCGTGATAGCT	ProMono
BM5-34p_GCCTCGACTAAA	HSC
BM5-34p_GCCTGAGGCCGT	Prog
BM5-34p_GCCTTACAGTAC	Prog
BM5-34p_GCCTTACATTGA	ProB
BM5-34p_GCCTTACGAGGT	GMP
BM5-34p_GCCTTCGGTAAG	HSC
BM5-34p_GCGAAATAGCTG	earlyEry
BM5-34p_GCGAAATGCTAG	HSC
BM5-34p_GCGAATATCTGT	HSC
BM5-34p_GCGACAACTCCC	HSC
BM5-34p_GCGACAGTGCAG	Prog
BM5-34p_GCGACGTTAACA	Prog
BM5-34p_GCGACTACGGTT	Prog
BM5-34p_GCGACTCAGTCT	Prog
BM5-34p_GCGATAGAAGGC	GMP
BM5-34p_GCGATGCGGTAT	ProB
BM5-34p_GCGCACGGCAAT	HSC
BM5-34p_GCGCCGTTATTT	HSC
BM5-34p_GCGCCTTATATA	Prog
BM5-34p_GCGCCTTCGCTC	Prog
BM5-34p_GCGCGGAGCTAA	Prog
BM5-34p_GCGCTTGCTATT	Prog
BM5-34p_GCGGACGTCTAC	Prog
BM5-34p_GCGGTCCGAGCA	HSC
BM5-34p_GCGGTGTTGTTA	earlyEry
BM5-34p_GCGTAACGTATG	earlyEry
BM5-34p_GCGTCCTTTCAT	earlyEry
BM5-34p_GCGTGAGATAAA	earlyEry
BM5-34p_GCGTGCCTACGC	Prog
BM5-34p_GCGTGTCGCACA	HSC
BM5-34p_GCGTTGCGTAGT	ProB
BM5-34p_GCGTTGTCCGGG	Prog
BM5-34p_GCTACGGTGATA	earlyEry
BM5-34p_GCTACTCGCTTA	HSC
BM5-34p_GCTAGGACTGAT	HSC
BM5-34p_GCTATTCTATAA	Prog
BM5-34p_GCTATTTCTCCC	earlyEry
BM5-34p_GCTCAGTCTAAC	HSC
BM5-34p_GCTCCGATAGTT	Prog
BM5-34p_GCTCGTGACCCT	HSC
BM5-34p_GCTGAGTCGACT	Prog
BM5-34p_GCTGCACCGGAC	Prog
BM5-34p_GCTGCCACAGAG	Prog
BM5-34p_GCTGCGACGCAT	Prog
BM5-34p_GCTGCTTGGTTT	ProB
BM5-34p_GCTGGGCTTTTA	Prog
BM5-34p_GCTGTGACATGA	Prog
BM5-34p_GCTTCTACCAAT	Prog
BM5-34p_GCTTGTATCTGG	Prog
BM5-34p_GGAAAAGGGGTG	Prog
BM5-34p_GGAACGAAACAC	HSC
BM5-34p_GGAAGAGAGGTA	Prog
BM5-34p_GGAAGTACGATC	Prog
BM5-34p_GGAATGCTACTG	earlyEry
BM5-34p_GGAATTTACTTC	Prog
BM5-34p_GGACATAAGAAT	ProB
BM5-34p_GGACCGCATCAA	HSC
BM5-34p_GGACGTTAGGCC	ProB
BM5-34p_GGACTCTCGTCC	Prog
BM5-34p_GGAGAAAGTATC	Prog
BM5-34p_GGAGAATAAGCA	Prog
BM5-34p_GGAGACTCATCA	HSC
BM5-34p_GGAGGCCTCTAT	HSC
BM5-34p_GGAGGCGTGACG	Prog
BM5-34p_GGAGTATGGAGC	Prog
BM5-34p_GGAGTGCGTTAA	Prog
BM5-34p_GGAGTGGCAATA	Prog
BM5-34p_GGATCCGTGTCG	Prog
BM5-34p_GGATGCTACCAG	Prog
BM5-34p_GGATGGGCGTGC	HSC
BM5-34p_GGATTCCTTTTT	Prog
BM5-34p_GGATTTGACCGC	GMP
BM5-34p_GGCAACAAATAT	ProB
BM5-34p_GGCAACCATCTG	HSC
BM5-34p_GGCAGACAGCGC	Prog
BM5-34p_GGCATTTGGTGG	HSC
BM5-34p_GGCCACCGTTCC	Prog
BM5-34p_GGCCATCGGTAC	GMP
BM5-34p_GGCCCCGCGCTA	HSC
BM5-34p_GGCCCCTAGCAG	HSC
BM5-34p_GGCCGAATGGCG	Prog
BM5-34p_GGCCGGCTGGTT	HSC
BM5-34p_GGCCTCCCGGTT	Prog
BM5-34p_GGCCTCTCTCCT	HSC
BM5-34p_GGCGAACGGTGT	earlyEry
BM5-34p_GGCGAATCAGTT	HSC
BM5-34p_GGCGAGGCGAGT	GMP
BM5-34p_GGCGGCTAGCTG	HSC
BM5-34p_GGCGGTTTCAAG	Prog
BM5-34p_GGCGTAAGGCTG	Prog
BM5-34p_GGCTAGTGTCGC	Prog
BM5-34p_GGCTCAAGAAGT	GMP
BM5-34p_GGCTCTTATTAT	HSC
BM5-34p_GGCTTGCTCATG	Prog
BM5-34p_GGGAACCCGTTT	HSC
BM5-34p_GGGACCCTTGGG	Prog
BM5-34p_GGGAGAATGAGA	Prog
BM5-34p_GGGAGGCACCCA	Prog
BM5-34p_GGGAGGGTTGAT	HSC
BM5-34p_GGGAGTGCTCAG	GMP
BM5-34p_GGGATGACAATA	Prog
BM5-34p_GGGATGTTGAAG	HSC
BM5-34p_GGGATTGGCCTT	Prog
BM5-34p_GGGCCCACGGCT	Prog
BM5-34p_GGGCGCAAGCGG	Prog
BM5-34p_GGGCGCAGCAAT	Prog
BM5-34p_GGGCGCCGTAAT	HSC
BM5-34p_GGGCGTAGACGT	Prog
BM5-34p_GGGGATTAGACG	Prog
BM5-34p_GGGGCAAACCCC	HSC
BM5-34p_GGGGCAATGTGC	HSC
BM5-34p_GGGGTCCCTATT	Prog
BM5-34p_GGGGTCCGCCAT	Prog
BM5-34p_GGGTAATCGCTT	HSC
BM5-34p_GGGTACAGACGG	ProB
BM5-34p_GGGTAGTGACCT	Prog
BM5-34p_GGGTGCTTACCG	ProB
BM5-34p_GGGTTCATGTGT	GMP
BM5-34p_GGGTTGCTAAGA	HSC
BM5-34p_GGTAACACTTCA	HSC
BM5-34p_GGTAAGCGGTGC	Prog
BM5-34p_GGTACAGCCCGC	HSC
BM5-34p_GGTACGGCACAG	Prog
BM5-34p_GGTACGGGCGAA	HSC
BM5-34p_GGTATCCGATTG	Prog
BM5-34p_GGTATCGACTAT	HSC
BM5-34p_GGTATTAAGTCA	Prog
BM5-34p_GGTATTATACCT	GMP
BM5-34p_GGTCAGGGATAA	ProB
BM5-34p_GGTCTGTGTACC	Prog
BM5-34p_GGTGAAATGTGA	earlyEry
BM5-34p_GGTGGTGCTGAT	Prog
BM5-34p_GGTTACTTTGCT	ProB
BM5-34p_GGTTCAAGACTC	Prog
BM5-34p_GGTTGCCCTTTA	GMP
BM5-34p_GGTTTCCTAGTA	Prog
BM5-34p_GGTTTCTCACCT	HSC
BM5-34p_GGTTTTTTGCGG	HSC
BM5-34p_GTAACACTATTT	Prog
BM5-34p_GTAACAGCGCGC	ProB
BM5-34p_GTAACGGGGGGA	ProB
BM5-34p_GTAACTACGTGC	Prog
BM5-34p_GTAAGGCTTTTG	Prog
BM5-34p_GTACATAACAAT	Prog
BM5-34p_GTACGAACTATC	ProB
BM5-34p_GTACGTAGCGCT	HSC
BM5-34p_GTACTGCTTGAG	HSC
BM5-34p_GTACTGGGCATG	HSC
BM5-34p_GTAGCGAACTGC	Prog
BM5-34p_GTAGCGGTTCGG	Prog
BM5-34p_GTAGGGGATTAT	HSC
BM5-34p_GTAGGTTACCCT	earlyEry
BM5-34p_GTAGTTCCATAT	Prog
BM5-34p_GTAGTTCCCCCT	HSC
BM5-34p_GTATACACATCT	HSC
BM5-34p_GTATCAAAGCCA	Prog
BM5-34p_GTATCAGCAGGA	Prog
BM5-34p_GTATCTCCCCAA	HSC
BM5-34p_GTATGAGGCCGG	GMP
BM5-34p_GTATGCTGCTGT	Prog
BM5-34p_GTATGGCGCAAT	HSC
BM5-34p_GTATTATCGCAT	Prog
BM5-34p_GTATTCTCATTA	Prog
BM5-34p_GTATTGTAGGTT	Prog
BM5-34p_GTATTTGAGGTA	GMP
BM5-34p_GTATTTTCCACA	Prog
BM5-34p_GTCAAACGTCAG	HSC
BM5-34p_GTCAACAAATTA	HSC
BM5-34p_GTCAATTCCTTC	HSC
BM5-34p_GTCACGCTCAGA	earlyEry
BM5-34p_GTCAGAATGATG	Prog
BM5-34p_GTCAGATTCGCG	HSC
BM5-34p_GTCAGGAACGCG	Prog
BM5-34p_GTCAGGTCCCCG	GMP
BM5-34p_GTCATATCCCGA	HSC
BM5-34p_GTCATGCGGCAG	Prog
BM5-34p_GTCCAATAGATG	GMP
BM5-34p_GTCCCACTACCC	HSC
BM5-34p_GTCCCCTGTTTA	Prog
BM5-34p_GTCCCTTAGCCC	Prog
BM5-34p_GTCGACGAATTG	Prog
BM5-34p_GTCGCTTGGGAT	HSC
BM5-34p_GTCGTCGCCAAG	HSC
BM5-34p_GTCGTTGAACGC	HSC
BM5-34p_GTCTAACCTTAG	Prog
BM5-34p_GTCTACATTGAC	HSC
BM5-34p_GTCTACGGACAC	Prog
BM5-34p_GTCTAGAGCCCC	HSC
BM5-34p_GTCTGACAGGCG	Prog
BM5-34p_GTCTGCAATATT	HSC
BM5-34p_GTCTGGGTCACC	Prog
BM5-34p_GTGACTGAAGGA	HSC
BM5-34p_GTGAGGTACCCT	Prog
BM5-34p_GTGAGTACCTGT	HSC
BM5-34p_GTGATCCGGGGN	earlyEry
BM5-34p_GTGATTTTTCCG	Prog
BM5-34p_GTGCAATAGATC	ProB
BM5-34p_GTGCACGCCATG	HSC
BM5-34p_GTGCACTTAGCA	earlyEry
BM5-34p_GTGCATAGTCCC	GMP
BM5-34p_GTGCGCACCGAT	HSC
BM5-34p_GTGCTCGCATCT	GMP
BM5-34p_GTGCTCTTCGCT	GMP
BM5-34p_GTGCTGAATCGA	HSC
BM5-34p_GTGCTTCTGACA	Prog
BM5-34p_GTGGAATTTGTC	Prog
BM5-34p_GTGGACTCATGC	Prog
BM5-34p_GTGGCATACACG	Prog
BM5-34p_GTGGCCTCTGAT	GMP
BM5-34p_GTGGCGAATTCA	Prog
BM5-34p_GTGGCGGCTGTG	Prog
BM5-34p_GTGGCTCGGAGA	HSC
BM5-34p_GTGGCTTCTAAC	HSC
BM5-34p_GTGGGAGAGATA	Prog
BM5-34p_GTGGGCATAGCT	Prog
BM5-34p_GTGGGCTCGACT	HSC
BM5-34p_GTGTAAGTATCA	HSC
BM5-34p_GTGTACCAAGAA	Prog
BM5-34p_GTGTACCAGTCC	HSC
BM5-34p_GTGTCGTCTGGT	Prog
BM5-34p_GTGTCTCTGATA	Prog
BM5-34p_GTGTCTGTCGCC	earlyEry
BM5-34p_GTGTTCTACAAC	HSC
BM5-34p_GTGTTGTCAAGG	HSC
BM5-34p_GTGTTTGTATCT	HSC
BM5-34p_GTGTTTTGAGAA	Prog
BM5-34p_GTTAATAATACC	earlyEry
BM5-34p_GTTACAGATCCC	earlyEry
BM5-34p_GTTACCCCGGAA	Prog
BM5-34p_GTTAGGGTATTG	Prog
BM5-34p_GTTCCATCGTAT	earlyEry
BM5-34p_GTTCCCCGATGT	HSC
BM5-34p_GTTCGGTTTTCC	Prog
BM5-34p_GTTCGTTCTCAC	Prog
BM5-34p_GTTCTGCTCCAT	GMP
BM5-34p_GTTGAAGCGAGT	Prog
BM5-34p_GTTGATTTCTTC	HSC
BM5-34p_GTTGCCTGTCAA	HSC
BM5-34p_GTTGGACACAAT	Prog
BM5-34p_GTTGGCACTGTC	Prog
BM5-34p_GTTGGGCTCGCT	Prog
BM5-34p_GTTGGTTTGGGA	earlyEry
BM5-34p_GTTGTTGTCTTT	earlyEry
BM5-34p_GTTTAGCCCCTA	earlyEry
BM5-34p_GTTTATTTAGGA	Prog
BM5-34p_GTTTCGAACCAC	GMP
BM5-34p_GTTTCTAATCGC	HSC
BM5-34p_GTTTGCGTGGCG	HSC
BM5-34p_GTTTGCTCCTAG	ProB
BM5-34p_GTTTGGTCCTTA	Prog
BM5-34p_GTTTTTGGTCAT	ProB
BM5-34p_TAAACCACCCTT	HSC
BM5-34p_TAAACTCGTTGC	ProB
BM5-34p_TAAACTTTAGAG	ProB
BM5-34p_TAAATCCCCGAA	Prog
BM5-34p_TAACACCACTGT	GMP
BM5-34p_TAACATAACCTT	Prog
BM5-34p_TAACATGCGAAT	GMP
BM5-34p_TAACATTACAGA	GMP
BM5-34p_TAACTGCAGCCC	HSC
BM5-34p_TAAGTGCAGAAT	Prog
BM5-34p_TAATATACGGCA	Prog
BM5-34p_TAATCAAAATTT	HSC
BM5-34p_TAATCTGCGTAT	HSC
BM5-34p_TAATTGTGAGGG	Prog
BM5-34p_TAATTTCATATT	HSC
BM5-34p_TACAACGGATCA	Prog
BM5-34p_TACAATCTGATA	Prog
BM5-34p_TACACAGCGATA	HSC
BM5-34p_TACACTTTACGG	HSC
BM5-34p_TACATGGGCTAT	ProB
BM5-34p_TACATTGTATTC	HSC
BM5-34p_TACCGCCGTACA	Prog
BM5-34p_TACCTGAAGCAC	HSC
BM5-34p_TACCTGCGCGTA	GMP
BM5-34p_TACCTTCCACTC	Prog
BM5-34p_TACGAGACTTAG	Prog
BM5-34p_TACGCAACGATG	Prog
BM5-34p_TACGCGTGCGGC	Prog
BM5-34p_TACGCTGCTCGT	Prog
BM5-34p_TACGTAACGCGC	Prog
BM5-34p_TACTATTTAGAC	Prog
BM5-34p_TACTGCAGCAAA	GMP
BM5-34p_TACTGGACAGGN	HSC
BM5-34p_TACTGTTCGACC	Prog
BM5-34p_TACTTGACTCAT	Prog
BM5-34p_TACTTTCGCGTA	HSC
BM5-34p_TAGAAGTTTCTG	Prog
BM5-34p_TAGAATTTTTAA	HSC
BM5-34p_TAGACCGTGGCG	Prog
BM5-34p_TAGACGCAAATG	Prog
BM5-34p_TAGACTTATTTC	HSC
BM5-34p_TAGAGACCGCAC	Prog
BM5-34p_TAGATAGGTATT	HSC
BM5-34p_TAGATGCAACCT	Prog
BM5-34p_TAGCAGAATTGG	HSC
BM5-34p_TAGCCAACTCTA	HSC
BM5-34p_TAGCGTGCTCCG	HSC
BM5-34p_TAGCTAGTCGAC	HSC
BM5-34p_TAGCTCATAGGG	Prog
BM5-34p_TAGCTTAGTTGT	HSC
BM5-34p_TAGTAAAGTACT	Prog
BM5-34p_TAGTACACGATC	earlyEry
BM5-34p_TAGTACCCACCC	Prog
BM5-34p_TAGTATATATTC	Prog
BM5-34p_TAGTATGGCACT	Prog
BM5-34p_TAGTCTGATGCA	Prog
BM5-34p_TAGTGCTTGTCT	Prog
BM5-34p_TAGTGTATCATC	earlyEry
BM5-34p_TAGTGTTTCCTC	Prog
BM5-34p_TAGTTAATGAAT	Prog
BM5-34p_TATCACTCAAAG	HSC
BM5-34p_TATCATGAACGG	Prog
BM5-34p_TATCCCAGGATA	HSC
BM5-34p_TATCGTCCTATT	Prog
BM5-34p_TATCTGGATCGA	HSC
BM5-34p_TATGACCAACCT	earlyEry
BM5-34p_TATGACTGTACC	HSC
BM5-34p_TATGACTTCTAC	Prog
BM5-34p_TATGGGAACCGC	GMP
BM5-34p_TATGTGGATCAC	Prog
BM5-34p_TATTAAGCTTAG	GMP
BM5-34p_TATTCCATCGTA	HSC
BM5-34p_TATTCTCGTTTG	Prog
BM5-34p_TATTGGCCAGCC	Prog
BM5-34p_TCACGGCATCAG	Prog
BM5-34p_TCACGGCCAGTT	Prog
BM5-34p_TCACTCCACCAT	Prog
BM5-34p_TCACTCCAGGCT	HSC
BM5-34p_TCACTTCCCCTA	HSC
BM5-34p_TCACTTGATTAC	Prog
BM5-34p_TCAGAAACTATT	Prog
BM5-34p_TCAGGCTCAACA	GMP
BM5-34p_TCAGTATGTTCC	ProB
BM5-34p_TCAGTCTTTCGC	Prog
BM5-34p_TCAGTGCTCCCA	HSC
BM5-34p_TCATCAGTAGCC	HSC
BM5-34p_TCATCCACCGGA	Prog
BM5-34p_TCATGCCATCCG	earlyEry
BM5-34p_TCATTGGGCAGC	Prog
BM5-34p_TCCACAGTCGCA	earlyEry
BM5-34p_TCCACCAACAAG	Prog
BM5-34p_TCCACTCTTGGT	Prog
BM5-34p_TCCAGCCCACGA	Prog
BM5-34p_TCCAGGTGATGG	Prog
BM5-34p_TCCATTACCACT	Prog
BM5-34p_TCCATTGCCCGT	HSC
BM5-34p_TCCCATCCGAAC	Prog
BM5-34p_TCCCATCTAACT	HSC
BM5-34p_TCCCGCAAATTC	HSC
BM5-34p_TCCCTAACCCTC	GMP
BM5-34p_TCCCTCGTATAC	Prog
BM5-34p_TCCCTTATGCTC	GMP
BM5-34p_TCCGACAGGCCA	Prog
BM5-34p_TCCGATGGCAAG	Prog
BM5-34p_TCCGCACGGCCC	HSC
BM5-34p_TCCGCTTATAAG	HSC
BM5-34p_TCCGTATGGTGA	HSC
BM5-34p_TCCGTTCGGCCA	Prog
BM5-34p_TCCTACTAGAGA	earlyEry
BM5-34p_TCCTCAAAGCCT	earlyEry
BM5-34p_TCCTTCCTATGC	HSC
BM5-34p_TCGAAACACACA	HSC
BM5-34p_TCGAAGTATCAA	Prog
BM5-34p_TCGACAGTAATC	Prog
BM5-34p_TCGAGGAACAGT	HSC
BM5-34p_TCGCCAATGCCG	Prog
BM5-34p_TCGCGAGGAACA	Prog
BM5-34p_TCGCTTACCCGG	HSC
BM5-34p_TCGCTTTTGCGG	HSC
BM5-34p_TCGGAATCTCAT	Prog
BM5-34p_TCGGATACTAGG	Prog
BM5-34p_TCGGTCCACCGA	HSC
BM5-34p_TCGTAGCCCTGA	HSC
BM5-34p_TCGTCAAATTCA	earlyEry
BM5-34p_TCGTTATATGTG	Prog
BM5-34p_TCGTTCGTTCGA	HSC
BM5-34p_TCGTTCTCCGAC	Prog
BM5-34p_TCTAACGGTATA	Prog
BM5-34p_TCTATAACGGAG	GMP
BM5-34p_TCTATATGGAAT	HSC
BM5-34p_TCTATTAGAGCA	HSC
BM5-34p_TCTCAACGGCAT	HSC
BM5-34p_TCTCACGGACAG	ProB
BM5-34p_TCTCATGCGGAG	ProB
BM5-34p_TCTCCACTGCCT	Prog
BM5-34p_TCTCCGGATTGC	HSC
BM5-34p_TCTCCTCTTTTA	Prog
BM5-34p_TCTCGAGCCGAT	Prog
BM5-34p_TCTCGATGGTCG	Prog
BM5-34p_TCTCTACCTTCT	ProB
BM5-34p_TCTCTCTCCTTN	Prog
BM5-34p_TCTGAAATATTT	HSC
BM5-34p_TCTGGAATTACG	earlyEry
BM5-34p_TCTGGCTATTTT	Prog
BM5-34p_TCTGTTACATTA	HSC
BM5-34p_TCTGTTACGCGC	earlyEry
BM5-34p_TCTTACCCCAAT	HSC
BM5-34p_TCTTAGCGGCTC	earlyEry
BM5-34p_TCTTCGGTTGCT	Prog
BM5-34p_TCTTGAATTGCT	Prog
BM5-34p_TCTTGATGCGCG	HSC
BM5-34p_TGAAACGACGAT	Prog
BM5-34p_TGAAACTGTCAG	Prog
BM5-34p_TGAAAGAGAGAA	GMP
BM5-34p_TGAAAGATCGCG	HSC
BM5-34p_TGAACACGTTAA	GMP
BM5-34p_TGAAGTAATTAA	Prog
BM5-34p_TGAATTGATCTG	earlyEry
BM5-34p_TGAATTGCTACC	Prog
BM5-34p_TGACAAACTCGG	ProB
BM5-34p_TGACAATAATTT	GMP
BM5-34p_TGACAGTAAGGC	Prog
BM5-34p_TGACAGTAGAAG	HSC
BM5-34p_TGACCTTTTTCT	Prog
BM5-34p_TGACGCCTTATC	Prog
BM5-34p_TGAGAATAGTGG	HSC
BM5-34p_TGAGCCCCGTGC	Prog
BM5-34p_TGAGCGAGTTAA	HSC
BM5-34p_TGATACCCTACG	HSC
BM5-34p_TGATAGTAGCGG	GMP
BM5-34p_TGATCTCACAAT	Prog
BM5-34p_TGATGAGCAGAG	Prog
BM5-34p_TGATGCCGTAGC	earlyEry
BM5-34p_TGATGGCAGACC	earlyEry
BM5-34p_TGATGTTACTAT	HSC
BM5-34p_TGATTATGGCGC	HSC
BM5-34p_TGATTCCACGTC	Prog
BM5-34p_TGATTGGCCGCG	HSC
BM5-34p_TGCAAATACGAT	Prog
BM5-34p_TGCAACTAACAG	Prog
BM5-34p_TGCAAGCGACTA	HSC
BM5-34p_TGCAAGCTAGTG	HSC
BM5-34p_TGCAATGTTGAG	Prog
BM5-34p_TGCACCTTGATC	HSC
BM5-34p_TGCATGAGGTCA	HSC
BM5-34p_TGCCAGTACTGA	GMP
BM5-34p_TGCCATAATGAA	HSC
BM5-34p_TGCCATCTGCCG	Prog
BM5-34p_TGCCCGTTTGCG	earlyEry
BM5-34p_TGCCGCGTTGCC	Prog
BM5-34p_TGCCTATCTCCT	HSC
BM5-34p_TGCCTGGCTTTA	HSC
BM5-34p_TGCCTTGTCGTG	GMP
BM5-34p_TGCGAAGTGGCA	Prog
BM5-34p_TGCGTAGCTCAG	HSC
BM5-34p_TGCTAATCACAC	Prog
BM5-34p_TGCTAGAACGGA	earlyEry
BM5-34p_TGCTAGCGTCCC	GMP
BM5-34p_TGCTAGGACCTA	Prog
BM5-34p_TGCTATCAAGAG	HSC
BM5-34p_TGCTCTGGGACA	HSC
BM5-34p_TGCTGGTGTCGT	Prog
BM5-34p_TGGAATGGCATG	earlyEry
BM5-34p_TGGACCCACGAG	GMP
BM5-34p_TGGAGATCCGCC	Prog
BM5-34p_TGGATAGTGAAC	HSC
BM5-34p_TGGATGTCGTGC	Prog
BM5-34p_TGGCACGTGCCC	Prog
BM5-34p_TGGCGCTCTATC	HSC
BM5-34p_TGGCGCTGCCTT	HSC
BM5-34p_TGGCTAAGTCGT	Prog
BM5-34p_TGGCTAGCCACC	HSC
BM5-34p_TGGCTCTGTTAT	Prog
BM5-34p_TGGCTGTGATTA	ProB
BM5-34p_TGGGAAAAGTTA	Prog
BM5-34p_TGGGCGCTAACC	GMP
BM5-34p_TGGGGATGTTAG	HSC
BM5-34p_TGGGTTCCGAGT	ProB
BM5-34p_TGGTACTAATTT	Prog
BM5-34p_TGGTATTGTGCT	Prog
BM5-34p_TGGTCATAGAAC	HSC
BM5-34p_TGGTCTCGAGCG	earlyEry
BM5-34p_TGGTGTTTAGTC	HSC
BM5-34p_TGGTTCGAGATA	earlyEry
BM5-34p_TGGTTTTCAGCG	ProB
BM5-34p_TGTAAGTAGCCT	Prog
BM5-34p_TGTACTCGTAGT	HSC
BM5-34p_TGTATAATGAAT	earlyEry
BM5-34p_TGTCACCGGATT	Prog
BM5-34p_TGTCATTTCAGA	HSC
BM5-34p_TGTCGCTCTAAT	Prog
BM5-34p_TGTCTGATTCCT	HSC
BM5-34p_TGTCTTCCAATT	HSC
BM5-34p_TGTGACCAAGGT	HSC
BM5-34p_TGTGGGATAAGA	ProB
BM5-34p_TGTGGTACCCGC	HSC
BM5-34p_TGTGGTTAAAAG	Prog
BM5-34p_TGTGGTTAGGAT	GMP
BM5-34p_TGTTCAACCAAA	Prog
BM5-34p_TGTTTAAGGAGG	Prog
BM5-34p_TGTTTTAAGGTT	Prog
BM5-34p_TGTTTTTTCACC	HSC
BM5-34p_TTAAACAAAATG	HSC
BM5-34p_TTAAAGTTGGAG	Prog
BM5-34p_TTAATTTCCGCT	HSC
BM5-34p_TTACAATGACGC	GMP
BM5-34p_TTACACAACACA	earlyEry
BM5-34p_TTACACGGTGTA	Prog
BM5-34p_TTACAGAGAGGA	Prog
BM5-34p_TTACGAAATACG	HSC
BM5-34p_TTACGCGACAAC	GMP
BM5-34p_TTAGAAAACCTT	Prog
BM5-34p_TTAGGACCGGGT	Prog
BM5-34p_TTAGGCGTTGCA	Prog
BM5-34p_TTAGGGCCCTTG	Prog
BM5-34p_TTAGGTTCGTTC	Prog
BM5-34p_TTAGTGTGGAGC	HSC
BM5-34p_TTAGTTGGCCTC	HSC
BM5-34p_TTAGTTTAACTC	Prog
BM5-34p_TTATATCTATCA	Prog
BM5-34p_TTATCCGATGCA	GMP
BM5-34p_TTATCGACCCAG	Prog
BM5-34p_TTATGGCTTTTA	Prog
BM5-34p_TTATGGGCAGAG	HSC
BM5-34p_TTATGTACGTCG	HSC
BM5-34p_TTATGTGCCGAA	Prog
BM5-34p_TTCAAAATAGGT	Prog
BM5-34p_TTCAACCAGCGA	Prog
BM5-34p_TTCAACCGAATG	Prog
BM5-34p_TTCAAGACAGCA	Prog
BM5-34p_TTCAAGTGAATA	Prog
BM5-34p_TTCACACCGTGT	Prog
BM5-34p_TTCACCAGGACG	HSC
BM5-34p_TTCACTGAGTGT	HSC
BM5-34p_TTCAGGAGCATA	Prog
BM5-34p_TTCATTTTTAAG	Prog
BM5-34p_TTCCATGTGGTA	HSC
BM5-34p_TTCCCAATTAGA	HSC
BM5-34p_TTCCCAGGCGGC	GMP
BM5-34p_TTCCCATTTTCT	HSC
BM5-34p_TTCCCGGGTATC	Prog
BM5-34p_TTCCCGTGAATC	HSC
BM5-34p_TTCCGCTGCCGT	Prog
BM5-34p_TTCCGGGTGGCG	Prog
BM5-34p_TTCCGGTAGTTC	HSC
BM5-34p_TTCCTAGCGTGG	Prog
BM5-34p_TTCCTGGTTATC	Prog
BM5-34p_TTCGACGGGGTC	GMP
BM5-34p_TTCGAGTGGGTG	HSC
BM5-34p_TTCGCTCGGGAT	HSC
BM5-34p_TTCGGGTTAGGG	Prog
BM5-34p_TTCGTCAATAAA	HSC
BM5-34p_TTCGTCAGTGAC	HSC
BM5-34p_TTCGTGTCCTTG	Prog
BM5-34p_TTCTCGGACCAC	HSC
BM5-34p_TTCTCTCTACAC	Prog
BM5-34p_TTCTCTTTCTCT	HSC
BM5-34p_TTCTGAACCCTG	HSC
BM5-34p_TTCTTTTAACCC	HSC
BM5-34p_TTGAACTCGGAA	ProB
BM5-34p_TTGAAGAGTCTC	Prog
BM5-34p_TTGATGACTCGG	HSC
BM5-34p_TTGCAATATCTG	Prog
BM5-34p_TTGCAGCTCTCC	Prog
BM5-34p_TTGCCGCATCGC	GMP
BM5-34p_TTGCCGTCATTT	GMP
BM5-34p_TTGCGCACACCT	Prog
BM5-34p_TTGCGTCGCTGG	Prog
BM5-34p_TTGCTCTCACTG	HSC
BM5-34p_TTGCTCTTCCTC	HSC
BM5-34p_TTGCTTTTGTCT	HSC
BM5-34p_TTGGATTGGCAT	Prog
BM5-34p_TTGGCACCCTAG	Prog
BM5-34p_TTGGCAGTATGT	HSC
BM5-34p_TTGGCCCGACTA	Prog
BM5-34p_TTGGGCGCTCAA	HSC
BM5-34p_TTGGGGGCGCTA	Prog
BM5-34p_TTGGTACCCTTC	HSC
BM5-34p_TTGTCCACTTAC	HSC
BM5-34p_TTGTCGGACTAG	HSC
BM5-34p_TTGTCGTGTCTG	Prog
BM5-34p_TTGTCTACACTC	earlyEry
BM5-34p_TTGTCTTTTCGG	Prog
BM5-34p_TTGTGAAACGAG	Prog
BM5-34p_TTGTGGCCGATC	Prog
BM5-34p_TTGTTATGTCAA	earlyEry
BM5-34p_TTGTTCAGTCGA	HSC
BM5-34p_TTGTTGCTAGCT	Prog
BM5-34p_TTGTTGGGTACT	Prog
BM5-34p_TTTAAAATAGTG	HSC
BM5-34p_TTTAAACATATC	Prog
BM5-34p_TTTAAACCGGTA	Prog
BM5-34p_TTTAACAGACCG	Prog
BM5-34p_TTTAAGAAGGTG	Prog
BM5-34p_TTTACCTCTGTA	HSC
BM5-34p_TTTACCTGCATG	Prog
BM5-34p_TTTACTTGATCG	GMP
BM5-34p_TTTATGGTAATG	GMP
BM5-34p_TTTCAACAGGGT	Prog
BM5-34p_TTTCACAGTTCT	ProB
BM5-34p_TTTCATGCCTAA	HSC
BM5-34p_TTTCATTATAGC	Prog
BM5-34p_TTTCCCCCGTGG	Prog
BM5-34p_TTTCCCTCTCGA	HSC
BM5-34p_TTTCGGGATCAC	HSC
BM5-34p_TTTCTCCGTCCT	Prog
BM5-34p_TTTCTGAAGACA	HSC
BM5-34p_TTTCTTTTCAGT	HSC
BM5-34p_TTTGCGACCGTA	Prog
BM5-34p_TTTGGATCAATG	HSC
BM5-34p_TTTGGCGGCACA	ProB
BM5-34p_TTTGGGTCCTCT	Prog
BM5-34p_TTTGGTCCCCCG	HSC
BM5-34p_TTTGGTGAGGTC	HSC
BM5-34p_TTTGTTAATAGA	HSC
BM5-34p_TTTGTTATGTGG	Prog
BM5-34p_TTTTATCGGCTA	Prog
BM5-34p_TTTTGACCAGAG	HSC
BM5-34p_TTTTGGCTAGTT	GMP
BM5-34p_TTTTTAGACGCG	Prog
BM5-34p_TTTTTAGTGCGT	Prog
BM5-34p38n_AAAAAAAGGAAC	HSC
BM5-34p38n_AAAACCTACAGA	HSC
BM5-34p38n_AAAATCGTCCGC	HSC
BM5-34p38n_AAAATTCTGGGT	HSC
BM5-34p38n_AAACACGCACAA	HSC
BM5-34p38n_AAACCTGACAAC	HSC
BM5-34p38n_AAACGTAGCGTG	HSC
BM5-34p38n_AAAGCACCCAAG	HSC
BM5-34p38n_AAAGCGCTGCGC	HSC
BM5-34p38n_AAAGGCGTGAAT	HSC
BM5-34p38n_AAAGTGTGATAG	HSC
BM5-34p38n_AAATAACCTCGA	HSC
BM5-34p38n_AAATACTCCCGT	HSC
BM5-34p38n_AAATCGCTGCAT	Prog
BM5-34p38n_AAATGTAACAAT	HSC
BM5-34p38n_AAATTAGCGACG	HSC
BM5-34p38n_AAATTGCCCCAA	Prog
BM5-34p38n_AACACGAGATAG	HSC
BM5-34p38n_AACAGCGGTCGC	HSC
BM5-34p38n_AACATATGCGGG	HSC
BM5-34p38n_AACCTGACTTAC	HSC
BM5-34p38n_AACGACGTTAGC	HSC
BM5-34p38n_AACGATTCATAG	HSC
BM5-34p38n_AACGTGAAGCAT	HSC
BM5-34p38n_AACTACAGTTGT	HSC
BM5-34p38n_AACTGTCTGCGG	HSC
BM5-34p38n_AACTTTATCTCA	HSC
BM5-34p38n_AAGCACTACCAC	HSC
BM5-34p38n_AAGCAGCGACAA	HSC
BM5-34p38n_AAGCCATGGTTA	HSC
BM5-34p38n_AAGCGCCAATTC	HSC
BM5-34p38n_AAGGAACGCCAC	HSC
BM5-34p38n_AAGGCTTGGTCA	HSC
BM5-34p38n_AAGGTTTTCTGA	HSC
BM5-34p38n_AAGTACTAGGTT	HSC
BM5-34p38n_AAGTCAACCATC	HSC
BM5-34p38n_AAGTCGGCCGGC	HSC
BM5-34p38n_AAGTTATGAGCG	HSC
BM5-34p38n_AAGTTCACACAC	HSC
BM5-34p38n_AAGTTCCGACGT	HSC
BM5-34p38n_AATCAGACCTAA	Prog
BM5-34p38n_AATCAGCACCCC	HSC
BM5-34p38n_AATCAGCCCTGG	HSC
BM5-34p38n_AATCCACTTCGA	HSC
BM5-34p38n_AATCGATTCGTA	HSC
BM5-34p38n_AATTGTTATCCT	HSC
BM5-34p38n_AATTTACCAGTG	HSC
BM5-34p38n_AATTTCGAAATG	HSC
BM5-34p38n_ACAAAGGCGGGT	HSC
BM5-34p38n_ACAACTAGGTGC	HSC
BM5-34p38n_ACAAGTCAGTGA	HSC
BM5-34p38n_ACAATTGCAGAG	HSC
BM5-34p38n_ACAATTGTAAGA	HSC
BM5-34p38n_ACACAATCTATA	HSC
BM5-34p38n_ACACACTTGCCT	HSC
BM5-34p38n_ACACGACCCTCA	HSC
BM5-34p38n_ACAGCAAATACC	HSC
BM5-34p38n_ACAGGCAGGATG	HSC
BM5-34p38n_ACATATAGTTCG	HSC
BM5-34p38n_ACATGGCCAGGG	Prog
BM5-34p38n_ACATGTCCCCAA	Prog
BM5-34p38n_ACCACGCCCCAT	HSC
BM5-34p38n_ACCACTCGTGCA	HSC
BM5-34p38n_ACCAGGGAGTAC	HSC
BM5-34p38n_ACCCAATCACCT	HSC
BM5-34p38n_ACCCAGATTCAC	Prog
BM5-34p38n_ACCCCCTTCTTG	Prog
BM5-34p38n_ACCGATCGGTAG	HSC
BM5-34p38n_ACCGCCCCCGGG	HSC
BM5-34p38n_ACCGCCTCTGGC	HSC
BM5-34p38n_ACCGGTCGCTAT	HSC
BM5-34p38n_ACCGGTTATGAC	HSC
BM5-34p38n_ACCGTGGTCTTC	HSC
BM5-34p38n_ACCTCAGTATTT	HSC
BM5-34p38n_ACCTGATATTTG	HSC
BM5-34p38n_ACCTTATAAGGA	HSC
BM5-34p38n_ACGACCCGGCTG	HSC
BM5-34p38n_ACGATGGACGGA	HSC
BM5-34p38n_ACGATGGGTATT	HSC
BM5-34p38n_ACGCCCATAACC	HSC
BM5-34p38n_ACGCTCATGAGG	HSC
BM5-34p38n_ACGCTTTGAGAA	HSC
BM5-34p38n_ACGGAAAAACGC	HSC
BM5-34p38n_ACGGGGACGCGA	HSC
BM5-34p38n_ACGTATGGAGGA	HSC
BM5-34p38n_ACGTATGTCCAG	HSC
BM5-34p38n_ACGTCTAAACGT	HSC
BM5-34p38n_ACGTCTGAGTAA	HSC
BM5-34p38n_ACGTTTACGTGA	HSC
BM5-34p38n_ACTAAGAATCTA	HSC
BM5-34p38n_ACTAGGAGCTAC	HSC
BM5-34p38n_ACTCCAGCACCC	HSC
BM5-34p38n_ACTCGCTTTCAG	HSC
BM5-34p38n_ACTGAAAAGACT	HSC
BM5-34p38n_ACTGATTGGCAG	HSC
BM5-34p38n_ACTGGTCGAGGT	HSC
BM5-34p38n_ACTTCAGCAAGT	HSC
BM5-34p38n_AGAAACGGATAT	HSC
BM5-34p38n_AGAAGGCATATT	HSC
BM5-34p38n_AGAATGTCAACC	HSC
BM5-34p38n_AGAATTCTAGTC	Prog
BM5-34p38n_AGACATTACCAT	Prog
BM5-34p38n_AGACTCCGGCGA	HSC
BM5-34p38n_AGACTGTTAACC	HSC
BM5-34p38n_AGACTTAAACGT	HSC
BM5-34p38n_AGAGCTGCTATC	HSC
BM5-34p38n_AGAGTCGGGCTG	HSC
BM5-34p38n_AGAGTCTTGCTT	Prog
BM5-34p38n_AGAGTGGACCTT	HSC
BM5-34p38n_AGAGTTTTGTGC	HSC
BM5-34p38n_AGATTGCGGGGA	HSC
BM5-34p38n_AGCAAATGTGAT	HSC
BM5-34p38n_AGCAATTACTTA	HSC
BM5-34p38n_AGCCACTCGATG	HSC
BM5-34p38n_AGCCACTTGACC	Prog
BM5-34p38n_AGCCCACTCCCA	HSC
BM5-34p38n_AGCCCTGACCAA	HSC
BM5-34p38n_AGCCTAGGGATT	HSC
BM5-34p38n_AGCGAATGAAGT	HSC
BM5-34p38n_AGCGAGGTACCT	HSC
BM5-34p38n_AGCTCACAAGGC	HSC
BM5-34p38n_AGCTGCCTGTTT	HSC
BM5-34p38n_AGCTGCTCAGGG	HSC
BM5-34p38n_AGCTGGATTTCT	HSC
BM5-34p38n_AGGAATTTAAGG	HSC
BM5-34p38n_AGGAGAACCTGG	HSC
BM5-34p38n_AGGAGCGTACGG	HSC
BM5-34p38n_AGGATGACGCCT	HSC
BM5-34p38n_AGGATGTCAGGA	HSC
BM5-34p38n_AGGCCATCGGAG	HSC
BM5-34p38n_AGGCCATTGTTT	HSC
BM5-34p38n_AGGCGCGGTGGC	HSC
BM5-34p38n_AGGCGTTTCTAT	HSC
BM5-34p38n_AGGGTACTTAAA	HSC
BM5-34p38n_AGGGTCCACACA	HSC
BM5-34p38n_AGGTGATCACGC	HSC
BM5-34p38n_AGGTTGTCTACA	HSC
BM5-34p38n_AGTACTTCGTCA	HSC
BM5-34p38n_AGTAGCAACTCG	HSC
BM5-34p38n_AGTATTTCGATT	HSC
BM5-34p38n_AGTCATGTCGGT	HSC
BM5-34p38n_AGTGAAAGGACA	HSC
BM5-34p38n_AGTGAGCGAGAA	HSC
BM5-34p38n_AGTGAGTCTCTT	HSC
BM5-34p38n_AGTGCTCTGAGT	HSC
BM5-34p38n_AGTGGCCTCGCT	HSC
BM5-34p38n_AGTGGCTGGAAC	HSC
BM5-34p38n_AGTGGTATCGTG	HSC
BM5-34p38n_ATAACACGGTAT	HSC
BM5-34p38n_ATAAGCACTGTT	Prog
BM5-34p38n_ATAAGGATGTTC	HSC
BM5-34p38n_ATACAAGGTAAG	HSC
BM5-34p38n_ATACAATAAGTC	HSC
BM5-34p38n_ATACCGCTTGTA	lateEry
BM5-34p38n_ATACCGGGTCGT	HSC
BM5-34p38n_ATAGAATGAGGA	HSC
BM5-34p38n_ATATATGACCAA	HSC
BM5-34p38n_ATATGCCCGACC	HSC
BM5-34p38n_ATATTGAGAATG	HSC
BM5-34p38n_ATCATTCTGTGG	HSC
BM5-34p38n_ATCCATGGGGCC	HSC
BM5-34p38n_ATCCCTTGTGCG	HSC
BM5-34p38n_ATCTAATTCACC	HSC
BM5-34p38n_ATCTCAGGTGAG	HSC
BM5-34p38n_ATCTCGGGTGCG	HSC
BM5-34p38n_ATCTCTAAATCC	HSC
BM5-34p38n_ATCTTTCATCGG	HSC
BM5-34p38n_ATGAAGGAAATG	HSC
BM5-34p38n_ATGACTCGAAGC	HSC
BM5-34p38n_ATGCGGCATAAT	HSC
BM5-34p38n_ATGGAAAAAGTG	Prog
BM5-34p38n_ATGGACTTACTC	HSC
BM5-34p38n_ATGGCGGAGAGC	HSC
BM5-34p38n_ATGGGGCAAGAA	HSC
BM5-34p38n_ATGGTTGTTCAT	HSC
BM5-34p38n_ATGTACTTCGAC	HSC
BM5-34p38n_ATGTGGCATATA	HSC
BM5-34p38n_ATTAACCACATT	HSC
BM5-34p38n_ATTACACCATTC	HSC
BM5-34p38n_ATTAGGGTCATT	HSC
BM5-34p38n_ATTATTAACGAG	HSC
BM5-34p38n_ATTCATAGATCT	HSC
BM5-34p38n_ATTCATGACGGT	HSC
BM5-34p38n_ATTCTTCAAAGA	HSC
BM5-34p38n_ATTGACCCTGGT	HSC
BM5-34p38n_ATTGCAGACGGT	HSC
BM5-34p38n_ATTGGTAGTATA	HSC
BM5-34p38n_ATTGTAATCATC	HSC
BM5-34p38n_ATTTACCTAGAT	HSC
BM5-34p38n_ATTTCAGTATGA	HSC
BM5-34p38n_ATTTCGTCCTGT	HSC
BM5-34p38n_ATTTGAGCTCAA	HSC
BM5-34p38n_ATTTGGCGAGCA	HSC
BM5-34p38n_CAAACGTTAGTA	HSC
BM5-34p38n_CAAAGCGACGTA	HSC
BM5-34p38n_CAACAGGAGACC	HSC
BM5-34p38n_CAACATCCAAGG	HSC
BM5-34p38n_CAACTATTGCTT	HSC
BM5-34p38n_CAACTCAACGGG	HSC
BM5-34p38n_CAACTCTGTTGC	HSC
BM5-34p38n_CAACTCTTTTAC	Prog
BM5-34p38n_CAAGAGTTCATA	HSC
BM5-34p38n_CAAGCACCTCGG	HSC
BM5-34p38n_CAAGCGGAGATG	HSC
BM5-34p38n_CAATAATCAGTC	HSC
BM5-34p38n_CAATACTTAACC	HSC
BM5-34p38n_CAATCTAATAGC	HSC
BM5-34p38n_CAATCTCGACTC	HSC
BM5-34p38n_CAATCTGTACGA	HSC
BM5-34p38n_CAATGCGACGGG	HSC
BM5-34p38n_CAATGTCCCATT	HSC
BM5-34p38n_CACGAGCCGAGG	HSC
BM5-34p38n_CACTCAAACCTT	HSC
BM5-34p38n_CACTTGGGCTTA	HSC
BM5-34p38n_CAGAAGTGCCTA	HSC
BM5-34p38n_CAGAGTCTAGAA	HSC
BM5-34p38n_CAGATCACACTA	HSC
BM5-34p38n_CAGCAATTTCTG	HSC
BM5-34p38n_CAGCCGAAGATC	HSC
BM5-34p38n_CAGCTTTTTTCT	HSC
BM5-34p38n_CAGGCTGATGGC	HSC
BM5-34p38n_CAGTCGTGTTTC	HSC
BM5-34p38n_CAGTGCGTTGTG	HSC
BM5-34p38n_CAGTTCGAAGGT	HSC
BM5-34p38n_CAGTTGAGATGT	HSC
BM5-34p38n_CATAGTTAGCCC	HSC
BM5-34p38n_CATATCTTGGCT	HSC
BM5-34p38n_CATCCGTTGGGG	HSC
BM5-34p38n_CATGATACCCAT	HSC
BM5-34p38n_CATGGCCATCAT	Prog
BM5-34p38n_CATGGTAGAATT	HSC
BM5-34p38n_CATGTTACAAGC	HSC
BM5-34p38n_CATTCCGAGGTA	HSC
BM5-34p38n_CATTGTACTAGT	HSC
BM5-34p38n_CATTTAAACTAA	HSC
BM5-34p38n_CATTTCTGTACA	HSC
BM5-34p38n_CATTTTCAGCAG	HSC
BM5-34p38n_CCAACTGTGGCG	HSC
BM5-34p38n_CCAACTGTTAGG	HSC
BM5-34p38n_CCAGAAGCGTAT	HSC
BM5-34p38n_CCAGCCACCGCA	HSC
BM5-34p38n_CCAGTAAGTGGA	HSC
BM5-34p38n_CCATATAGATGC	HSC
BM5-34p38n_CCATGAGGGGAG	HSC
BM5-34p38n_CCATGAGTGGTC	HSC
BM5-34p38n_CCATTCTAGTGG	HSC
BM5-34p38n_CCATTGTCACGG	HSC
BM5-34p38n_CCCATAACTTAG	HSC
BM5-34p38n_CCCATTTGGTGT	HSC
BM5-34p38n_CCCCACGTTAGA	HSC
BM5-34p38n_CCCCATGAACTA	HSC
BM5-34p38n_CCCCATGGAGGA	HSC
BM5-34p38n_CCCCGTATGGCT	HSC
BM5-34p38n_CCCGATGCTGTT	HSC
BM5-34p38n_CCCTAGATGCAT	HSC
BM5-34p38n_CCGAAACGTCGT	HSC
BM5-34p38n_CCGACATTCCAC	HSC
BM5-34p38n_CCGACTGCGCAG	HSC
BM5-34p38n_CCGAGACCGCTT	HSC
BM5-34p38n_CCGAGCCGGTGA	HSC
BM5-34p38n_CCGAGCTACCTA	HSC
BM5-34p38n_CCGAGTCAAGCA	HSC
BM5-34p38n_CCGATCGGAATT	HSC
BM5-34p38n_CCGATCTGCTCT	HSC
BM5-34p38n_CCGCCAGAGCTC	HSC
BM5-34p38n_CCGCGACCCAGG	Prog
BM5-34p38n_CCGGACTTCGCA	HSC
BM5-34p38n_CCGGATAAACGG	HSC
BM5-34p38n_CCGGCTCGATTA	HSC
BM5-34p38n_CCGTACAAAGGT	HSC
BM5-34p38n_CCGTATACATTC	HSC
BM5-34p38n_CCGTATGCGGCT	HSC
BM5-34p38n_CCGTCGCCTTAT	HSC
BM5-34p38n_CCGTCTTTGTTT	HSC
BM5-34p38n_CCGTGCGTATAT	HSC
BM5-34p38n_CCGTTATAGGGT	HSC
BM5-34p38n_CCTAATCTGACC	HSC
BM5-34p38n_CCTAGATCTGGG	HSC
BM5-34p38n_CCTCTATTAGAG	HSC
BM5-34p38n_CCTGCTACATCA	HSC
BM5-34p38n_CCTGGAATAACT	HSC
BM5-34p38n_CCTGGTTTTGAT	HSC
BM5-34p38n_CCTTATGAGCCA	HSC
BM5-34p38n_CCTTGGCGAGCG	HSC
BM5-34p38n_CCTTTAACAAGT	HSC
BM5-34p38n_CGAAATGGGGAG	HSC
BM5-34p38n_CGAACTGACGGG	HSC
BM5-34p38n_CGAATAAATATT	Prog
BM5-34p38n_CGAATATCTGGG	HSC
BM5-34p38n_CGACAGAACAGT	HSC
BM5-34p38n_CGACAGATCGGA	HSC
BM5-34p38n_CGACGCTTATTC	HSC
BM5-34p38n_CGACTTCCGTTA	HSC
BM5-34p38n_CGAGACTTCCGC	HSC
BM5-34p38n_CGAGATACGATG	HSC
BM5-34p38n_CGAGATTGAAGC	HSC
BM5-34p38n_CGATAACTTACA	HSC
BM5-34p38n_CGATCGCTAGAA	HSC
BM5-34p38n_CGATCTACGTGC	HSC
BM5-34p38n_CGATGCCCCCTT	HSC
BM5-34p38n_CGATGTAAACAA	HSC
BM5-34p38n_CGCACGAGGGCG	HSC
BM5-34p38n_CGCAGGTCTCGA	HSC
BM5-34p38n_CGCAGGTCTGGG	HSC
BM5-34p38n_CGCATGACGATG	HSC
BM5-34p38n_CGCCCACGGTCT	HSC
BM5-34p38n_CGCCCTACCCCA	HSC
BM5-34p38n_CGCCGTGCGGGC	HSC
BM5-34p38n_CGCCTGCATTTT	Prog
BM5-34p38n_CGCGATTTGTTA	HSC
BM5-34p38n_CGCTGAAGCCAG	HSC
BM5-34p38n_CGCTGGGTTCAG	HSC
BM5-34p38n_CGCTGTACTGGG	HSC
BM5-34p38n_CGCTGTGGCTGT	HSC
BM5-34p38n_CGCTTCGCCACG	HSC
BM5-34p38n_CGCTTTTGAATA	HSC
BM5-34p38n_CGGAAGGGAGTC	HSC
BM5-34p38n_CGGACACTGCCT	HSC
BM5-34p38n_CGGACCAGAGTC	HSC
BM5-34p38n_CGGACGACGACG	HSC
BM5-34p38n_CGGATCAACTCT	HSC
BM5-34p38n_CGGATCGGTTCG	HSC
BM5-34p38n_CGGCAATCAATT	HSC
BM5-34p38n_CGGCTCCGACTA	HSC
BM5-34p38n_CGGCTGAGGAAC	HSC
BM5-34p38n_CGGCTTAAAGCA	HSC
BM5-34p38n_CGGCTTACTCAG	HSC
BM5-34p38n_CGGCTTTATAAG	HSC
BM5-34p38n_CGGTCCTGATTT	HSC
BM5-34p38n_CGGTTTACTAGT	HSC
BM5-34p38n_CGTAAGCAAGGC	HSC
BM5-34p38n_CGTACATCGCAT	HSC
BM5-34p38n_CGTAGAGGTCTT	HSC
BM5-34p38n_CGTATAGCCGAG	HSC
BM5-34p38n_CGTATGAGGACG	Prog
BM5-34p38n_CGTCAGATTTTT	HSC
BM5-34p38n_CGTCCATTAGCG	HSC
BM5-34p38n_CGTCCTCTTGGG	HSC
BM5-34p38n_CGTGACAAGTTT	HSC
BM5-34p38n_CGTGAGTTCAAG	HSC
BM5-34p38n_CGTGATCAGGCT	HSC
BM5-34p38n_CGTGATCGAATT	HSC
BM5-34p38n_CGTGGATCCCTC	HSC
BM5-34p38n_CGTTAATTCCAA	Prog
BM5-34p38n_CGTTACGCCAGA	HSC
BM5-34p38n_CGTTCCGTTTCT	HSC
BM5-34p38n_CGTTCTGTGGCC	HSC
BM5-34p38n_CGTTGCCGCAGC	HSC
BM5-34p38n_CTAAAATCCCCT	HSC
BM5-34p38n_CTAACACCCGCA	HSC
BM5-34p38n_CTAACTAGGAAT	HSC
BM5-34p38n_CTAATCAACCGA	HSC
BM5-34p38n_CTACAACTAAAG	HSC
BM5-34p38n_CTACAATTTTAC	HSC
BM5-34p38n_CTACACAGCGTG	HSC
BM5-34p38n_CTACACCACGAG	HSC
BM5-34p38n_CTACATGCTCTC	HSC
BM5-34p38n_CTACTATAATAC	HSC
BM5-34p38n_CTACTCAGGAGC	HSC
BM5-34p38n_CTACTCTACCTG	HSC
BM5-34p38n_CTACTGGGAGCG	HSC
BM5-34p38n_CTATCGCAAGGT	HSC
BM5-34p38n_CTATTACACACC	HSC
BM5-34p38n_CTATTACCCCAT	HSC
BM5-34p38n_CTATTAGCTTGC	Prog
BM5-34p38n_CTATTTGACGAT	HSC
BM5-34p38n_CTCAAAAGATCC	HSC
BM5-34p38n_CTCACTCATCCG	HSC
BM5-34p38n_CTCATGGAGCCA	HSC
BM5-34p38n_CTCCATGGCGAA	HSC
BM5-34p38n_CTCCTCTGGGTT	HSC
BM5-34p38n_CTCCTGCCGCCT	HSC
BM5-34p38n_CTCGCGGTGCCC	HSC
BM5-34p38n_CTCGCTCTGTGA	HSC
BM5-34p38n_CTCGGCGATGAA	HSC
BM5-34p38n_CTCGTGGCACTG	HSC
BM5-34p38n_CTCTCGCATTAG	HSC
BM5-34p38n_CTCTTCGACCAT	HSC
BM5-34p38n_CTGAATCCGAAC	HSC
BM5-34p38n_CTGAGAGGGGCC	HSC
BM5-34p38n_CTGAGCCGCCTA	HSC
BM5-34p38n_CTGATATCCCTC	HSC
BM5-34p38n_CTGATTTTGGGT	Prog
BM5-34p38n_CTGCCAAGGAAC	HSC
BM5-34p38n_CTGCCGAGTAAT	HSC
BM5-34p38n_CTGCCGGCCCTG	HSC
BM5-34p38n_CTGCCTTAGTTA	HSC
BM5-34p38n_CTGGACCCTGTG	HSC
BM5-34p38n_CTGTACTCATAG	HSC
BM5-34p38n_CTGTAGAACGCA	HSC
BM5-34p38n_CTGTAGAAGACT	HSC
BM5-34p38n_CTGTCAAGCGCC	HSC
BM5-34p38n_CTGTGAGCCATA	HSC
BM5-34p38n_CTGTTGCCGATA	HSC
BM5-34p38n_CTGTTGTCTCCC	HSC
BM5-34p38n_CTGTTGTGAACA	HSC
BM5-34p38n_CTTAATACTAGG	HSC
BM5-34p38n_CTTCAATCGATA	HSC
BM5-34p38n_CTTCAGTCATTG	HSC
BM5-34p38n_CTTCATCATTTG	HSC
BM5-34p38n_CTTCCTTACGGA	HSC
BM5-34p38n_CTTGACGTCCTG	HSC
BM5-34p38n_CTTGCATCCAGC	HSC
BM5-34p38n_CTTGCCACGCCT	HSC
BM5-34p38n_CTTGCTCTGCCT	HSC
BM5-34p38n_CTTGGCAAGGTT	HSC
BM5-34p38n_CTTGTACTTACA	HSC
BM5-34p38n_CTTGTCTCTCCC	HSC
BM5-34p38n_CTTTGATCAACA	HSC
BM5-34p38n_CTTTGCCACGGT	HSC
BM5-34p38n_CTTTGCTCTGCT	HSC
BM5-34p38n_CTTTGGAGGTTC	Prog
BM5-34p38n_GAAAAGCCATGT	HSC
BM5-34p38n_GAAACCGCGAAC	HSC
BM5-34p38n_GAAAGACTTTTC	HSC
BM5-34p38n_GAACACACGGAG	HSC
BM5-34p38n_GAAGGTTTAGGT	HSC
BM5-34p38n_GAATCGAATGTA	HSC
BM5-34p38n_GAATGTCGTATA	Prog
BM5-34p38n_GACAGAGTGTAT	HSC
BM5-34p38n_GACAGGCCGCGC	HSC
BM5-34p38n_GACCACGAGTCG	HSC
BM5-34p38n_GACCCCGTGATC	HSC
BM5-34p38n_GACCCCTGAACC	HSC
BM5-34p38n_GACCGACGTGTT	HSC
BM5-34p38n_GACCTATGAATA	HSC
BM5-34p38n_GACCTTTGAGGC	HSC
BM5-34p38n_GACGCCAGAGTC	HSC
BM5-34p38n_GACGCTTATTTT	HSC
BM5-34p38n_GACGGGCAAACC	HSC
BM5-34p38n_GACGGGGAGCTC	HSC
BM5-34p38n_GACGTCTCCTTT	HSC
BM5-34p38n_GACTATAACGAC	HSC
BM5-34p38n_GACTGGGCTCTC	HSC
BM5-34p38n_GACTTAACCCCC	HSC
BM5-34p38n_GAGACTTGCACC	HSC
BM5-34p38n_GAGAGGTTCAAA	HSC
BM5-34p38n_GAGCCACGATCG	HSC
BM5-34p38n_GAGCCTAGAGGT	HSC
BM5-34p38n_GAGCGCACAATG	HSC
BM5-34p38n_GAGCGGGAGGTT	HSC
BM5-34p38n_GAGCGGTGGATT	HSC
BM5-34p38n_GAGGAACCGCGA	HSC
BM5-34p38n_GAGGATCGTTTA	HSC
BM5-34p38n_GAGTGGTACGCC	HSC
BM5-34p38n_GAGTTCATTGGC	HSC
BM5-34p38n_GAGTTCTTCGAT	HSC
BM5-34p38n_GATCACAACATC	HSC
BM5-34p38n_GATCACTTACAT	HSC
BM5-34p38n_GATCGGGCCCGT	HSC
BM5-34p38n_GATGCTGATGGT	HSC
BM5-34p38n_GATGTGCTCACG	HSC
BM5-34p38n_GATTGGGCTCTT	HSC
BM5-34p38n_GCATATCTGTTA	HSC
BM5-34p38n_GCCACACCGCCC	HSC
BM5-34p38n_GCCCACTTCGGC	HSC
BM5-34p38n_GCCCATGCCATC	HSC
BM5-34p38n_GCCCCCCAGCGT	HSC
BM5-34p38n_GCCCCGCAGCCC	Prog
BM5-34p38n_GCCCGCCTCCGG	HSC
BM5-34p38n_GCCCTAACTGCA	HSC
BM5-34p38n_GCCCTGGACGGC	HSC
BM5-34p38n_GCCGGGATTGAC	HSC
BM5-34p38n_GCCGTATTGATG	HSC
BM5-34p38n_GCCTCAAGATGC	HSC
BM5-34p38n_GCCTCCGCGGAC	Prog
BM5-34p38n_GCCTTCTGACGT	HSC
BM5-34p38n_GCCTTTCTCTGA	HSC
BM5-34p38n_GCGAGTCCCAAC	HSC
BM5-34p38n_GCGCGCCCTAGA	HSC
BM5-34p38n_GCGCGTTCAAAA	HSC
BM5-34p38n_GCGCTCCCGTGC	HSC
BM5-34p38n_GCGCTTGTCCAA	HSC
BM5-34p38n_GCGGAAATGCCA	HSC
BM5-34p38n_GCGGAGCTGGAC	HSC
BM5-34p38n_GCGGCGGGAAAA	HSC
BM5-34p38n_GCGGGTCTACAG	HSC
BM5-34p38n_GCGTAGGCTGCG	HSC
BM5-34p38n_GCGTCGATGGTA	HSC
BM5-34p38n_GCGTCGCGGTTC	HSC
BM5-34p38n_GCGTCGGGCCGG	HSC
BM5-34p38n_GCGTCTGCATGG	HSC
BM5-34p38n_GCGTGCCTGTTA	HSC
BM5-34p38n_GCGTTCAACCGC	HSC
BM5-34p38n_GCTATAAAGCAT	HSC
BM5-34p38n_GCTATCTGGCTA	HSC
BM5-34p38n_GCTATGATATAG	HSC
BM5-34p38n_GCTATTTCCATG	HSC
BM5-34p38n_GCTCGTGTCTCC	HSC
BM5-34p38n_GCTCTCGTCCAT	GMP
BM5-34p38n_GCTCTGGTGCGC	HSC
BM5-34p38n_GCTGACCGTTTC	Prog
BM5-34p38n_GCTGACTTGTTA	HSC
BM5-34p38n_GCTGGACCGTAA	HSC
BM5-34p38n_GCTGTACCCCCC	Prog
BM5-34p38n_GCTGTCAAGTAG	HSC
BM5-34p38n_GCTTCAAGTCAG	HSC
BM5-34p38n_GCTTTGCCGGTC	HSC
BM5-34p38n_GGAAACATTAGA	HSC
BM5-34p38n_GGAAGCTTCGAG	HSC
BM5-34p38n_GGACATGACATC	HSC
BM5-34p38n_GGACGTCACCGC	HSC
BM5-34p38n_GGACTCTTTAAA	Prog
BM5-34p38n_GGAGAATCTCCT	HSC
BM5-34p38n_GGAGATTGGTAT	HSC
BM5-34p38n_GGAGCTTGCGCA	HSC
BM5-34p38n_GGAGTGCGGTGT	HSC
BM5-34p38n_GGATTCCTTTGC	HSC
BM5-34p38n_GGATTTCGGTTA	HSC
BM5-34p38n_GGCAAACATGGG	HSC
BM5-34p38n_GGCAGACGGGCA	HSC
BM5-34p38n_GGCATCTCCGGC	HSC
BM5-34p38n_GGCCGCCCGCAG	HSC
BM5-34p38n_GGCGGCTGGCGA	HSC
BM5-34p38n_GGCGGGCTGTAG	HSC
BM5-34p38n_GGCGTAAACCAG	HSC
BM5-34p38n_GGCGTCAATGCG	HSC
BM5-34p38n_GGCGTGCATCAA	HSC
BM5-34p38n_GGCTATGATAAA	HSC
BM5-34p38n_GGGAACCACAAT	HSC
BM5-34p38n_GGGAGCGTAACG	HSC
BM5-34p38n_GGGATTATCTTC	HSC
BM5-34p38n_GGGATTCCGGAA	HSC
BM5-34p38n_GGGCACGCTCAT	HSC
BM5-34p38n_GGGCCTCTGCCT	HSC
BM5-34p38n_GGGCTAGAATGG	HSC
BM5-34p38n_GGGGACCGACCT	HSC
BM5-34p38n_GGGTGGCCAAAT	HSC
BM5-34p38n_GGGTTATGTAGT	HSC
BM5-34p38n_GGGTTGTGCAAG	HSC
BM5-34p38n_GGGTTTACGCTT	HSC
BM5-34p38n_GGTACCCGACGA	HSC
BM5-34p38n_GGTAGCAAGCAT	HSC
BM5-34p38n_GGTCATCACCAT	HSC
BM5-34p38n_GGTCCGTAGCTA	HSC
BM5-34p38n_GGTCTCGCTGAT	HSC
BM5-34p38n_GGTCTGGGCTCC	HSC
BM5-34p38n_GGTGGGTCAGAT	HSC
BM5-34p38n_GGTGTAGCTAGA	HSC
BM5-34p38n_GGTTAAGATTTG	HSC
BM5-34p38n_GGTTAGATCGAG	Prog
BM5-34p38n_GGTTATCAGGGC	HSC
BM5-34p38n_GGTTGATTCGCG	HSC
BM5-34p38n_GGTTTGATATTC	HSC
BM5-34p38n_GTAAACCCATCC	HSC
BM5-34p38n_GTAAAGGCTCGG	HSC
BM5-34p38n_GTAAATCTTGCT	HSC
BM5-34p38n_GTAACTTCGCGC	HSC
BM5-34p38n_GTACCCACATTG	HSC
BM5-34p38n_GTACGTCTTTTT	HSC
BM5-34p38n_GTAGTGTTAGTT	HSC
BM5-34p38n_GTATAACTAGTT	HSC
BM5-34p38n_GTATACGATAGA	HSC
BM5-34p38n_GTATACTACACT	HSC
BM5-34p38n_GTATAGTCCGAA	HSC
BM5-34p38n_GTATTCCTCGTT	HSC
BM5-34p38n_GTATTCTCCATC	HSC
BM5-34p38n_GTATTGGTTCAC	HSC
BM5-34p38n_GTCAGGTGAGGA	HSC
BM5-34p38n_GTCATTAAGGGC	HSC
BM5-34p38n_GTCATTTGGTGA	HSC
BM5-34p38n_GTCCAGCCGCTA	HSC
BM5-34p38n_GTCCCATTTCGA	HSC
BM5-34p38n_GTCCCGTCAATC	Prog
BM5-34p38n_GTCGAACGGGCC	HSC
BM5-34p38n_GTCGAGCGCGAG	HSC
BM5-34p38n_GTCGCACCATGC	HSC
BM5-34p38n_GTCGCTCTCGAT	HSC
BM5-34p38n_GTCTCAAAAATA	HSC
BM5-34p38n_GTCTCATGCGTA	HSC
BM5-34p38n_GTCTCGGCCACG	HSC
BM5-34p38n_GTCTGAAGACAA	HSC
BM5-34p38n_GTCTGAGCTTGG	HSC
BM5-34p38n_GTGACCGCGTGC	HSC
BM5-34p38n_GTGACGCACAGA	HSC
BM5-34p38n_GTGAGCCAGTGT	HSC
BM5-34p38n_GTGATGCCCCCC	HSC
BM5-34p38n_GTGATTTAATCC	HSC
BM5-34p38n_GTGCATCACGAG	HSC
BM5-34p38n_GTGCATTACGTG	HSC
BM5-34p38n_GTGCCCGTGGTA	HSC
BM5-34p38n_GTGGATGAGCGA	HSC
BM5-34p38n_GTGGCAACACAG	HSC
BM5-34p38n_GTGGCAATCGTT	HSC
BM5-34p38n_GTGGGCCGAGGG	Prog
BM5-34p38n_GTGGGTAACGAC	HSC
BM5-34p38n_GTGGTAAGGGCC	HSC
BM5-34p38n_GTGTGCGGCGAN	HSC
BM5-34p38n_GTTAGTTCCGCC	HSC
BM5-34p38n_GTTCCGCCGAGG	HSC
BM5-34p38n_GTTCCGGGTGCG	HSC
BM5-34p38n_GTTCGTATAATG	HSC
BM5-34p38n_GTTGACTCCATG	HSC
BM5-34p38n_GTTGCATGGTAA	HSC
BM5-34p38n_GTTTTGGCCTAT	HSC
BM5-34p38n_TAAGAGGTGACA	HSC
BM5-34p38n_TAAGCAGGTTTG	HSC
BM5-34p38n_TAAGCCCGTAGG	HSC
BM5-34p38n_TAAGCTATTCAT	HSC
BM5-34p38n_TAAGTGAAGTCC	HSC
BM5-34p38n_TAATGGCCCCGA	HSC
BM5-34p38n_TAATTACCAGGA	Prog
BM5-34p38n_TACACCTACAGC	HSC
BM5-34p38n_TACATCCGCGTT	HSC
BM5-34p38n_TACCAAAGCAAT	Prog
BM5-34p38n_TACCAATGACGA	HSC
BM5-34p38n_TACCAGGTCGCC	HSC
BM5-34p38n_TACCGAGCGCTG	HSC
BM5-34p38n_TACCGTAGGAAG	HSC
BM5-34p38n_TACCTGGTTACC	HSC
BM5-34p38n_TACGACCTAGCA	HSC
BM5-34p38n_TACGGAGAAGTA	HSC
BM5-34p38n_TACGGGCTTAAT	HSC
BM5-34p38n_TACTAAACAAGA	HSC
BM5-34p38n_TACTAACATAGA	HSC
BM5-34p38n_TACTGCTTTCCG	HSC
BM5-34p38n_TACTTCGAAGGC	HSC
BM5-34p38n_TAGAGCTCTCTC	HSC
BM5-34p38n_TAGCATGTGACC	HSC
BM5-34p38n_TAGCCCCGGGTG	HSC
BM5-34p38n_TAGCGTCTGCTG	HSC
BM5-34p38n_TAGTTCTAGACC	HSC
BM5-34p38n_TATACATGTAAT	HSC
BM5-34p38n_TATAGGCGGCAG	HSC
BM5-34p38n_TATATGCATCAC	HSC
BM5-34p38n_TATATGTGATTT	HSC
BM5-34p38n_TATCACAGTAGC	HSC
BM5-34p38n_TATCACTACGCC	HSC
BM5-34p38n_TATCAGCGTATT	HSC
BM5-34p38n_TATCCCAGTACA	HSC
BM5-34p38n_TATCGAAGTCAG	HSC
BM5-34p38n_TATGGGCTGGGG	HSC
BM5-34p38n_TATTAATCAGTC	HSC
BM5-34p38n_TATTCGTATTCA	HSC
BM5-34p38n_TATTGAGATGCT	HSC
BM5-34p38n_TCAAGTCCTTAC	HSC
BM5-34p38n_TCAATTTCTGCT	HSC
BM5-34p38n_TCACGTGCCCGG	HSC
BM5-34p38n_TCACTTGTACCC	HSC
BM5-34p38n_TCAGAGTAAAGA	HSC
BM5-34p38n_TCATACGGTACC	HSC
BM5-34p38n_TCATAGAGAGCC	HSC
BM5-34p38n_TCATGCATACCT	HSC
BM5-34p38n_TCATTGCCCGAA	HSC
BM5-34p38n_TCATTGTATGGA	HSC
BM5-34p38n_TCCATCATGACT	HSC
BM5-34p38n_TCCATCGGCGGA	HSC
BM5-34p38n_TCCATGATAAGA	HSC
BM5-34p38n_TCCCAGGACCCG	HSC
BM5-34p38n_TCCCATGCGGCT	HSC
BM5-34p38n_TCCCCGGCGGTA	HSC
BM5-34p38n_TCCCGTACAATA	HSC
BM5-34p38n_TCCGAACTATGG	HSC
BM5-34p38n_TCCGTAATACTG	HSC
BM5-34p38n_TCCTACCATGGT	HSC
BM5-34p38n_TCCTATGAAAAC	HSC
BM5-34p38n_TCCTCAGGCCAC	HSC
BM5-34p38n_TCCTTGGTAGAC	HSC
BM5-34p38n_TCCTTTGCATGC	HSC
BM5-34p38n_TCGAATCCGTCT	HSC
BM5-34p38n_TCGATTAAGATT	HSC
BM5-34p38n_TCGATTTTTTTC	HSC
BM5-34p38n_TCGCAAGAGAGG	HSC
BM5-34p38n_TCGCACATGGTA	HSC
BM5-34p38n_TCGCAGCACCCT	HSC
BM5-34p38n_TCGCATCTGCTT	HSC
BM5-34p38n_TCGCGGGTATTA	HSC
BM5-34p38n_TCGCTCTAACGG	HSC
BM5-34p38n_TCGGACCATGCA	HSC
BM5-34p38n_TCGGCATGGACC	HSC
BM5-34p38n_TCGGCTAGGGAG	HSC
BM5-34p38n_TCGGGAATCTTT	HSC
BM5-34p38n_TCGGGTGCTCGT	HSC
BM5-34p38n_TCGTAAGGACAT	HSC
BM5-34p38n_TCGTCAGTAGCG	HSC
BM5-34p38n_TCGTGGGTCGCG	HSC
BM5-34p38n_TCGTTAACTGTA	HSC
BM5-34p38n_TCGTTTACGATT	HSC
BM5-34p38n_TCTAACCTCCGG	HSC
BM5-34p38n_TCTACTTCGGTA	HSC
BM5-34p38n_TCTATGATCTGC	HSC
BM5-34p38n_TCTCCGACATAG	HSC
BM5-34p38n_TCTCGCGCACAC	HSC
BM5-34p38n_TCTCGTTTAAAC	HSC
BM5-34p38n_TCTGACGAGCTC	HSC
BM5-34p38n_TCTGCGTACGCA	HSC
BM5-34p38n_TCTGTTCTGACG	HSC
BM5-34p38n_TCTTCGCAGGCT	HSC
BM5-34p38n_TCTTTTCTGCGG	Prog
BM5-34p38n_TGAAATACTGAT	HSC
BM5-34p38n_TGAAATCTTTTG	HSC
BM5-34p38n_TGAACCCCTTTC	HSC
BM5-34p38n_TGAACGAGGCCG	HSC
BM5-34p38n_TGAACGTCGTTC	HSC
BM5-34p38n_TGACACCGATTA	HSC
BM5-34p38n_TGACCCGCTTTG	HSC
BM5-34p38n_TGACGGGCTTGT	HSC
BM5-34p38n_TGAGGTACTCGA	HSC
BM5-34p38n_TGAGTGCGCGGA	HSC
BM5-34p38n_TGAGTTATGTAA	HSC
BM5-34p38n_TGATAGGCCGAG	HSC
BM5-34p38n_TGATGCATGAAG	HSC
BM5-34p38n_TGCACAGCACGA	HSC
BM5-34p38n_TGCAGAGGAGAT	HSC
BM5-34p38n_TGCAGGAAAGCC	HSC
BM5-34p38n_TGCATGGTTTTA	HSC
BM5-34p38n_TGCCACAGGTTA	HSC
BM5-34p38n_TGCCCGAGGGTG	HSC
BM5-34p38n_TGCCGATATACC	HSC
BM5-34p38n_TGCCGGGCTCCG	HSC
BM5-34p38n_TGCGATGCGCGT	HSC
BM5-34p38n_TGCGGCGGGTAT	HSC
BM5-34p38n_TGCTAAACTCAT	HSC
BM5-34p38n_TGCTCATGGAAG	HSC
BM5-34p38n_TGCTCCTCCGAG	HSC
BM5-34p38n_TGGAAACTTGTG	HSC
BM5-34p38n_TGGATTGCTGCG	Prog
BM5-34p38n_TGGCGGAACAGC	HSC
BM5-34p38n_TGGCGGCCGCCG	HSC
BM5-34p38n_TGGCGTACACAA	HSC
BM5-34p38n_TGGCGTCACGCG	HSC
BM5-34p38n_TGGGACGAGTAA	HSC
BM5-34p38n_TGGGCTAGTATA	HSC
BM5-34p38n_TGGGCTTCTTCC	HSC
BM5-34p38n_TGGGGGCCTCAC	HSC
BM5-34p38n_TGGGGTTATATA	HSC
BM5-34p38n_TGGGTCGGTACG	HSC
BM5-34p38n_TGGTAACGCGAT	HSC
BM5-34p38n_TGGTCAATTATA	HSC
BM5-34p38n_TGGTGTTCTGGA	HSC
BM5-34p38n_TGGTTGGACTTT	HSC
BM5-34p38n_TGTAACGATACC	HSC
BM5-34p38n_TGTAGCTTGCTG	HSC
BM5-34p38n_TGTCAATCCCCC	HSC
BM5-34p38n_TGTCAGGGTCCG	HSC
BM5-34p38n_TGTCATCCATCT	HSC
BM5-34p38n_TGTCCATGGGCG	HSC
BM5-34p38n_TGTCTCGGGAAG	HSC
BM5-34p38n_TGTGAACCGACG	HSC
BM5-34p38n_TGTGACCCAGGA	HSC
BM5-34p38n_TGTGACTTTGAG	HSC
BM5-34p38n_TGTGATGACAGC	HSC
BM5-34p38n_TGTGCAAATCGA	HSC
BM5-34p38n_TGTGCGGCTCCC	HSC
BM5-34p38n_TGTGGAACCTGC	HSC
BM5-34p38n_TGTGGACAAGCA	Mono
BM5-34p38n_TGTGGTTCAGGG	HSC
BM5-34p38n_TGTTAGTGTGAC	HSC
BM5-34p38n_TGTTCCCCGCAG	HSC
BM5-34p38n_TGTTGGTGTTTN	HSC
BM5-34p38n_TGTTTACAGACA	HSC
BM5-34p38n_TGTTTAGAGTAC	HSC
BM5-34p38n_TTAATCTGATCC	HSC
BM5-34p38n_TTACATACTACA	HSC
BM5-34p38n_TTACCTCCAGAT	HSC
BM5-34p38n_TTAGACCGGATT	HSC
BM5-34p38n_TTATAATCTCTC	HSC
BM5-34p38n_TTATCGTCGCGC	HSC
BM5-34p38n_TTATCTCCCCCT	HSC
BM5-34p38n_TTATGCCGACAC	HSC
BM5-34p38n_TTATGTGTCATT	HSC
BM5-34p38n_TTCAACCGAACA	HSC
BM5-34p38n_TTCAGGTGGACA	HSC
BM5-34p38n_TTCCAATGGAGC	HSC
BM5-34p38n_TTCCCTAAACCT	Prog
BM5-34p38n_TTCGAGGCATCT	HSC
BM5-34p38n_TTCGCTAATATT	HSC
BM5-34p38n_TTCGTCACAGTT	HSC
BM5-34p38n_TTCTCCCCCCAT	HSC
BM5-34p38n_TTCTCTTGGTGG	HSC
BM5-34p38n_TTCTGGTCGCTG	HSC
BM5-34p38n_TTCTTCCTGCCG	HSC
BM5-34p38n_TTCTTTGCTTCT	Prog
BM5-34p38n_TTGAAGTGTCGA	HSC
BM5-34p38n_TTGAATCTCTCG	HSC
BM5-34p38n_TTGACAATCGAC	HSC
BM5-34p38n_TTGACCTATACG	HSC
BM5-34p38n_TTGAGAACGATT	HSC
BM5-34p38n_TTGATCGAGTCG	HSC
BM5-34p38n_TTGCTCAAAGAC	HSC
BM5-34p38n_TTGGAGGTCCGT	HSC
BM5-34p38n_TTGGGAGTCAGC	HSC
BM5-34p38n_TTGGGTGCTAGA	HSC
BM5-34p38n_TTGGTCCAAACG	HSC
BM5-34p38n_TTGGTCGAAACT	HSC
BM5-34p38n_TTGGTTTTATGC	HSC
BM5-34p38n_TTGTAAGGTTGA	HSC
BM5-34p38n_TTGTAGGAAGGA	HSC
BM5-34p38n_TTGTATCCTCCC	HSC
BM5-34p38n_TTGTCTCACCCC	HSC
BM5-34p38n_TTGTGAAGGCTA	HSC
BM5-34p38n_TTGTGGTGCAAC	HSC
BM5-34p38n_TTGTGTGTTGTC	HSC
BM5-34p38n_TTGTTCTGACTC	HSC
BM5-34p38n_TTTAGGGTGACT	HSC
BM5-34p38n_TTTATCAGCGCC	HSC
BM5-34p38n_TTTATCTACATC	HSC
BM5-34p38n_TTTCATTGCTAT	HSC
BM5-34p38n_TTTCCGTCCCAA	HSC
BM5-34p38n_TTTGACGAAATT	Prog
BM5-34p38n_TTTGATCGCTGC	HSC
BM5-34p38n_TTTGCGGCGCGG	Prog
BM5-34p38n_TTTGGTGACTCC	HSC
BM5-34p38n_TTTGGTGCTGTA	HSC
BM5-34p38n_TTTGTTCGAAAA	HSC
BM5-34p38n_TTTTGTCCCAAG	HSC
BM5-34p38n_TTTTGTGCTTTG	HSC
